3comvax	3Com Corporation	Santa Clara, CA
aaahq01	American Automobile Association, Hea	Heathrow, Florida
aablue	AA Blueprint Co., Inc.	Ohio
aardvark	Steve's Unix System, Portland	Portland, Oregon
abekas	Abekas Video Systems Inc, Redwood Ci	Redwood City, CA
abhg	ABHG Computing	Danville, CA
abode	Abode Computer Services	El Monte, CA
absolut	Absolut Software	Newton, MA
abstl	Anheuser-Busch, Inc.	St Louis, Missouri
abtcser	Abbott Labs.	Abbott Park, IL
abvax	Allen-Bradley Company, Inc.	Highland Heights O
acad	Autodesk Inc.	Sausalito, CA
acheron	Ciliophora Associates	Ossining, New York
acich	Automated Concepts, Inc. (Chicago)	Illinois
acsm	Aikido Computer Systems, Ltd.	Melville, New York
actisb	Actis in Berlin GmbH	Germany
ada3	Boeing Commercial Airplane	Seattle, WA
adaptex	Adaptec Inc.	Grapevine, Texas
adelie	Adelie Corporation	Cambridge, MA
adobe	Adobe Systems Incorporated	Mountain View, CA
adsi	Application Data Systems, Inc.	Memphis, Tennessee
aetech	Aetech, Inc.	Carlsbad, CA
agora	The Open Communication Forum	Portland, Oregon
aicchi	Analysts International Corp., Chicag	Schaumburg, IL
aim1	Aztec Information Management (Pty)	ROGGEBAAI
aimed	Acme Computing	Ontario
aimt	AIM Technology	Santa Clara, CA
ajfcal	Crafield Digital Inc.	Canada
akix	CxS Technology	San Diego, CA
alantec	Alantec Inc.	San Jose, CA
alberta	University of Alberta, Dept. of Comp	Canada
alchemy	Alchemy Software Designs	Corona, California
alembic	Alembic Computer Services Co.	McLean, Virginia
aleph	Aleph	Santa Clara, CA
alfalfa	Alfalfa Software, Inc.	Cambridge, MA
alias	Alias Research Inc.	Toronto, Ontario
allegra	AT&T Bell Laboratories	Murray Hill, NJ
alliant	Alliant Computer Systems Corporation	Littleton, MA
aloha1	Department of Electrical Engineering	Honolulu, Hawaii
alpha	Assistive Device Resource Center	Indiana USA
alps	American LP Systems, Inc.	Bohemia, New York
althea	Shakedown Street Public Access Unix	New Brunswick, NJ
altitude	Communications Accessibles Montreal	CANADA
alzabo	Midnight Software Inc.	Canada
amara	Applied Dynamics International, Inc.	Ann Arbor, MI
amc	Applied Microsystems Corporation	Redmond, WA
amc-gw	Applied Microsystems Corporation	Redmond, WA
amcad	American Academy of Arts and Science	Massachusetts
amd	Advanced Micro Devices, Inc.	Sunnyvale, CA
amdahl	Amdahl Corporation, UTS Products Gro	Sunnyvale, CA
amdcad	Ken Barry	San Jose, CA
ameritec	Ameritec Corporation / NetWatch Divi	Covina, California
ames	NASA Ames Research Center	Moffett Field, CA
amgraf	Amgraf, Inc.	Kansas City, MO
amiserv	Amiga Network Information Systems	Lisle, Illinois
amix	Commodore Business Machines	West Chester, PA
amperif	Amperif Corporation	Omaha, Nebraska
ampex	Ampex Corporation	Redwood City, CA
amtfocus	Motorola, Inc. General Systems Secto	Arlington Heights
anacom1	Anacom General Corp.	Anaheim, CA
anagld	Analytics, Inc.	Columbia, MD
analogy	Analogy Inc.	Oregon
anasaz	Anasazi, Inc.	Phoenix, Arizona
andromeda	Rutgers Univ., Center for Computer	Newark, New Jersey
anet	Arbornet Inc, Community-access UNIX.	Ann Arbor, MI
anomaly	Small Business Systems, Incorporated	Esmond, RI
antares	Folsom Processes Engineering, Intel	Folsom, California
antiem	University of Vermont, Division of	Burlington, VT
anvil	Stratus Computer, Inc.	Marlboro, MA
anwar	HHB Systems	Mahwah, New Jersey
apci-sc	Apollo Computer, Inc.	Santa Clara, CA
apcichi	Apollo Computer Inc., Chicago Region	Illinois
apcihq	Hewlett-Packard Company	Chelmsford, MA
apcimsp	Apollo Computer Inc., Minneapolis,	Bloomington, MN
apcisea	Apollo Computer, Inc	Bellevue, WA
apctrc	Amoco Production Company, Tulsa Rese	Oklahoma
apex	Apex Computer Company	Redmond, WA
apexepa	Apex Software Corporation	Pittsburgh, PA
apin	Alberta Packet Information Network	CANADA
apl-em	Applied Physics Lab, University of	Seattle, WA
aplcen	Johns Hopkins University, APL Center	Laurel, MD
apollo	Hewlett-Packard Company	Chelmsford, MA
apple	Apple Computer, Inc.	Cupertino, CA
applicon	Schlumberger Technologies CAD/CAM di	Billerica, MA
applix	Applix, Incorporated	Westboro, MA
aps	Applied Processing Systems, Inc.	Ann Arbor, MI
apt	APT Technology, Inc.	San Jose, CA
arc	Advansoft Research Corporation	Santa Clara, CA
arcbsys	ARC Business Systems, Inc.	San Diego, CA
arclev	Richard L. Zuccarini & Asc.	Sepulveda, CA
arcturus	Rockwell International	Anaheim, CA
ardent	Ardent Computer Corporation	Sunnyvale, CA
argon	Lightspace Designs	Highland Park, NJ
argosy	MasPar Computer Corporation	Sunnyvale, CA
arinc	Aeronautical Radio, Inc.	Annapolis, MD
arizona	University of Arizona Computer Scien	Tucson, Arizona
ark	Southwestern Bell Telephone Co.	W Capitol, RM
arnold	Dave Arnold (An individual)	Mission Viejo, CA
array	Array Systems Computing, Inc.	Canada
artecon	Artecon Inc.	Carlsbad, CA
ashtate	Ashton-Tate	Torrance, CA
asi	Assessment Systems, Inc.	Philadelphia, PA
asiux1	Ameritech Applied Technologies, Inc.	Arlington Heights
ast	Northrop Corporation, Electronics Sy	Rolling Meadows IL
astroatc	Astronautics Technology Center	Madison, Wisconsin
astrovax	Princeton University, Dept. of Astro	Princeton, NJ
asuvax	Arizona State University, Engineerin	Tempe, Arizona
asylum	The Asylum	Belmont, CA
atari	Atari Corporation	Sunnyvale, CA
atexnet	Atex, Inc., An Eastman Kodak Subsidi	Billerica, MA
atexrd	Atex, Division of EPPS	Bedford, MA
atha	Athabasca University	Canada
athertn	Atherton Technology	Sunnyvale, CA
atina	Ministerio de Relaciones Exteriores	ARGENTINA
attain	Teradyne, Inc. Industrial/Consumer	San Jose, CA
attcan	AT&T Canada Inc.	Canada
atti07	AT&T International Operations Suppor	Basking Ridge, NJ
attvcr	AT&T Canada Inc.	Canada
aubsch	Auburn School Dept.	Auburn, Maine
aucis	Computer Science, Andrews University	Berrien Springs MI
audfax	AudioFAX, Inc.	Mableton, Georgia
auspex	Auspex Systems, Inc.	Santa Clara, CA
austral	D.O.C. Data Processing Systems	Naperville, IL
austsun	Sun Microsystems, Inc.	Dallas, Texas
auxnj	Cincinnati Bell Information Systems	Piscataway, NJ
avalon	Avalon, Through the Mists...	Redmond, WA
avatar	Avatar Consultants	Canoga Park, CA
avcocan	Avco Financial Services Ltd.	Canada
avcoint	Avco Financial Services INTL ISD	Irvine, California
avsd	Ampex Corporation	Redwood City, CA
award	Award Software, Inc	Los Gatos, CA
axis	Axis Digital	France
b-tech	Branch Technology	Ann Arbor, MI
bacchus	Durham Software Company	Durham, NC
badile	Institut fuer Integrierte Systeme,	Switzerland
balkan	Tools & Techniques, Inc.	Austin, Texas
balr	BALR Corporation	Oak Brook, IL
balrog	The Mines of Moria	Brookline, NH
bambam	On Word, Inc.	Santa Monica, CA
banana	Federal Express Corp.	Memphis, Tennessee
bang	Marquis Company	La Jolla, CA
baron	Shore Intermediate Maintenance Activ	San Diego, CA
bartal	Bartal Design Group, Inc.	Englewood, NJ
bartek1	Bartek Associates, Inc.	Barrington, IL
basis	BASIS Inc.	Emeryville, CA
batcomputer	Cornell University, Cornell Theory	Engineering and Th
bbn	Bolt Beranek and Newman Inc.	Cambridge, MA
bc-cis	Brooklyn College of CUNY	Brooklyn, New York
bcm	Baylor College of Medicine	Texas
bcosi	Bell Canada - Technology Services De	Canada
bcsaic	Boeing Computer Services Advanced Te	Seattle, WA
bcsfse	Boeing Computer Services Field Servi	Seattle, WA
bcsl	Business Computer Systems Ltd.	Canada
bdmrrr	BDM International, Inc.	McLean, Virginia
bdt	Beckemeyer Development Tools	Oakland, CA
beartrk	Bear Track Computer Company	Takoma Park, MD
beast	UNIX Review Magazine	San Francisco, CA
beaudin	residence	Canada
beauty	Happy Man Corp., publishing Solid Va	Vashon Island, WA
beeper	CPR, Inc.	Glen Burnie, MD
bei	Brandt Electronics Inc.	Mountain View, CA
bellcore	Bell Communications Research, Morris	Morristown, NJ
benton	Pre-Press Technologies, Inc.	Ca USA
beowulf	Function Consulting	Wisc
berner	Berner Information Inc.	Ontario
bert	Digital Source, Inc., San Diego CA	SD, California
beyonet	Beyonet Network	Bensalem, PA
bgsuvax	Bowling Green State Univ.	Bowling Green, OH
bigtex	Institute of Applied Cosmology	Austin, Texas
bigtuna	Bekesey Lab, Neurobiology, Pacific	Honolulu, Hawaii
bilanc	Computer Guidance & Support	Littleton, CO
bilver	Orlando Connection	Winter Park, FL
binky	Binky	Berkeley, CA
bionet	GenBank Online Service	Mountain View, CA
bit	Bipolar Integrated Technology, Inc.	Beaverton, Oregon
blender	not an organization	Alberta
bles	William T. Blessum, M.D.- Physical	Pearl River, LA
blia	Sharebase Corporation	Los Gatos, CA
blinky	Commodity Futures, Inc.	Woodside, CA
bliss	Stetson University, Dept. of Mathema	DeLand, Florida
blister	Solbourne Computer of Canada, Ltd.	Canada
blkhole	Research Unlimited	Escondido, CA
blnosz	Lise-Meitner-Schule, Oberstufenzentr	Germany
bloom-beacon	MIT Student Information Processing	Cambridge, MA
blunile	Blue Nile Software	Canada
bnr-vpa	Bell Northern Research, Dept 2J23	Canada
bnrmtv	Bell Northern Research, Mountain Vie	Mountain View, CA
boake2	Small Systems Consulting	Florida
bodedo	Matchmaker Electronic Pen-Pal Networ	Austin Texas
bogart	Internal Revenue Service, Computer	Washington, DC
bongo	The Hole in the Wall	California
boo	Bob Marrow	Concord, CA
boop	The C-Group	Bonita, California
bootstrap	Statisics and Operations Research,	Princeton, NJ
borg	Unix Security Newsletter	Seattle, WA
boulder	University of Colorado, Boulder	Boulder, Colorado
bpa	Bell Atlantic Company	Philadelphia, PA
brambo	Bramalea Software Systems Inc.	Ontario
bridge2	3Com Corporation, Network Systems Di	Santa Clara, CA
brindle	H&S Engineering	Cardiff by the Sea
bronson	Microvation Consultants	Madison, CT
brspyr1	BRS Software Products, A Division of	Latham, New York
brunix	Brown University	Providence, RI
bsu-cs	Department of Computer Science, Ball	Indiana
bthpyd	Bethel College	St Paul, Minnesota
btni	Boys Town National Research Hospital	Omaha, Nebraska
btr	BTR Communications Company	Mountain View, CA
bu-cs	Boston University, CS Dept.	Boston, MA
bu-tyng	Boston University Corporate Educatio	Tyngsboro, MA
bungia	NAPS International	St Paul, Minnesota
bunker	ISC/Bunker Ramo	Shelton, CT
bunny	GTE Laboratories	Waltham, MA
burdvax	Unisys Corporation, Paoli Research	Paoli, PA
buroco	BuroComp Inc.	Canada
bytepb	BYTE (McGraw-Hill)	Peterborough, NH
bywater	IBM TJ Watson Research Center	Yorktown Heights N
c3pe	C3, Incorporated, Design Engineering	Herndon, Virginia
ca1	Science And Technology Center	Apple Valley, CA
cacilj	CACI Products Company, La Jolla	La Jolla, CA
cadnetix	Dazix Corporation	Boulder, Colorado
cadovax	Contel Business Systems, Computer Op	Torrance, CA
cadre	University of Pittsburgh, Decision	Pittsburgh, PA
cadreor	Cadre Technologies	Beaverton, Oregon
cae780	Comdisco Systems Inc.	Foster City, CA
caeco	Mentor Graphics / IC Group	USA
caen	College of Engineering, University	Ann Arbor, MI
caladan	Caladan, Homeworld of House Atreides	Redmond, WA
caldwr	California Department of Water Resou	Sacramento, CA
calmasd	Computervision (Calma) - A Division	San Diego, CA
camber	Home machine	Seminole, Florida
camco	Seattle Unix User's Group (Slug)	Mercer Island, WA
camtwh	Orama Incorporated	Canada
canada	VE6BBM/VE6TCP Packet Radio Gateway	Edmonton, Alberta
canisius	Canisius College Computer Science De	New York
canstar	Alcatel Canada Wire, Inc.	Canada
cantuar	Computer Science, University of Cant	New Zealand
capmkt	Capital Market Technology, Inc.	Berkeley, CA
capone	Computer Consoles Inc., CPD	Irvine, California
casemo	CASE / Datatel, Inc.	Annapolis Junction
casper	Casper's Place QNX	OR USA
castle	The Castle PAUS	Millwood, New York
cayman	Cayman Systems, Inc.	Cambridge, MA
cbmtor	Commodore Business Machines Limited	Canada
cbmvax	Commodore Business Machines	West Chester, PA
cca	Computer Corporation of America	Cambridge, MA
cccan	Canadian Computer/Communications All	Canada
cci632	Computer Consoles, Inc., Communicati	Rochester, NY
ccicpg	ICL Advanced Development, Irvine CA	Irvine, California
ccnysci	City College of New York	New York, New York
cctb	Chemical Computer Thinking Battery	Bellevue, WA
cdbhp1	Emory University Cardiac Data Bank	Atlanta, Georgia
cdin-1	CompuData Inc.	Phila, PA
cdl	Clarendon Datex Ltd.	West Vancouver, BC
cdp	Community Data Processing(CdP)	Menlo Park, CA
cdscom	Coines Dealership Systems	Hunt Valley, MD
cdspr	Center for Digital Signal Processing	Piscataway, NJ
cedm01	AT&T Canada (Edmonton Office)	Edmonton Alberta
celerity	FPS Computing, San Diego	San Diego, CA
celia	Rhythm & Hues, Inc.	Hollywood, CA
celit	Cray Research Superservers Inc., San	San Diego, CA
censor	Bell Canada, Technology Research -	Canada
cepu	UCLA Dept. of Neurology / VA Wadswor	Los Angeles, CA
cerl	US Army Construction Engineering Res	Champaign, IL
cfcl	Canta Forda Computer Laboratory	Pacifica, CA
cfctech	Chrysler Financial Corp, MIS, Distri	Southfield, MI
cfg	Caine, Farber & Gordon, Inc.	Pasadena, CA
cfisun	The Consumer Financial Institute	Waltham, MA
cg-atla	Agfa Compugraphic Division	Mass
cgh	Chimitt Gilman Homchick, Inc.	Wayne, PA
chara	Center for High Angular Resolution	Atlanta, Georgia
cherniak	Cherniak Giblon	Ontario Canada
chinacat	Unicom Systems Development, Inc.	Austin, Texas
chinet	Chinet - Public Access Un*x	Ill
chip	M/A-COM Government Systems Inc.	San Diego, CA
chips	Chips and Technologies, San Jose	San Jose, CA
chkpt	CheckPoint Computing	San Jose, CA
chp	Coach House Press	CANADA
chuo	Chuo Trust & Banking, CO. Ltd.	New York, New York
chvax	UNIX Interessengemeinschaft Schweiz	Zuerich
cichlid	Independent Consultant	Felton, California
cinele	Cincinnati Electronics, Corp	Ohio
cipric	Ciprico, Inc	Plymouth, MN
cit-vax	California Institute of Technology,	Pasadena, CA
citi	Center for Information Technology In	Ann Arbor, MI
cjsa	C. Jeffery Small and Associates	Mercer Island, WA
clif	Clif Flynt	Ypsilanti, MI
clipper	Intergraph Corp, Advanced Processor	Palo Alto, CA
clmqt	Enterprise Information System	Marquette, MI
cloud9	Stratus Computer, Inc.	Marlboro, MA
clout	/usr/group/chicago, inc.	Chicago, Illinois
clsib21	CLSI, Inc.	Newtonville, MA
clunk	Home computer of Don McKillican	Canada
cmcl2	New York University	New York, New York
cmkrnl	Kernel Mode Consulting	San Diego, CA
cms2	Christian Medical & Dental Society	Richardson, Texas
cmucspt	Carnegie Mellon University, School	Pittsburgh, PA
cnseq1	Oracle Corporation Canada, MIS Dept.	Canada
cocktrice	Mike's Playground	New Mexico
cogent	Cogent Software Solutions, Inc.	Stockton, CA
cognos	Cognos Incorporated	Canada
coherent	Coherent Thought Inc.	Palo Alto, CA
cohesive	Racal-Milgo	Los Gatos, CA
colnet	Columbus Public Access Usenet Distri	Pickerington, Ohio
colossus	edm enterprises	Woodinville, WA
columbia	Department of Computer Science, Colu	New York, New York
com50	Com Squared Systems	Eagan, Minnesota
comback	Relay Site	Quebec
compus	CompuSoft - Business Systems Develop	Canada
comspec	Comspec	Toronto Ontario
comsto	Comstock Associates	Sunnyvale, CA
conexch	Dighera Data Services	Santa Ana, CA
consci	Concurrent Sciences, inc.	Moscow, Idaho
contact	loeffler & co.	scarborough ont
contek	Connection Technologies	Harvard, MA
convex	Convex Computer Corporation	Richardson, Texas
cookie	Tiger Software, Inc.	Omaha, Nebraska
cooper	The Cooper Union for the Advancement	NY, New York
coplex	Copper Electronics, Inc.	Louisville, KY
cornell	Cornell University, Computer Science	Ithaca, New York
corpane	Corpane Industries Incorporated	Louisville, KY
corton	Fnet, c/o INRIA	France
corum	Unisys Corporation	Eagan, Minnesota
cos	Corporation for Open Systems	McLean, Virginia
cosi	COS, Inc.	Lawrenceville, NJ
coxeng1	Cox Engineering Company	Brighton, MA
coyote	Datalog Consulting	Tucson, Arizona
cp1	Chesapeake & Potomac Tel. Companies,	Silver Spring, MD
cp2	Chesapeake & Potomac Tel. Companies,	Silver Spring, MD
cp4	Chesapeake & Potomac Tel. Companies,	Silver Spring, MD
cpmx	Chesapeake & Potomac Tel. Companies,	Silver Spring, MD
cprmtn	Cooper Mountain R&D	Beaverton, Oregon
cpro	My Gateway system	Hayward, CA
cpsolv	Computer Problem Solving	Kansas
crackers	Clearpoint Research Corp.	Hopkinton Mass
crash	CTS Network Services	El Cajon, CA
cray	Cray Research, Inc.	Eagan, Minnesota
crayamid	Cray Research, Inc.	Mendota Heights MN
crdgw1	GE Corporate R&D Center	Schenectady, NY
crdos1	GE Corporate R&D Center	Schenectady, NY
crpmks	CIBA-GEIGY Corp. Dept. of Coatings,	Hawthorne, NY
crsfld	Crosfield - Camex - Hastech, Inc.	Manchester, NH
crucible	PowerTools	Austin, Texas
crux	Midnix - Mid-South Unix Users	Memphis, Tennessee
cruzio	Cruzio	Santa Cruz, CA
cs-col	NCR E&M-Columbia Customer Services	W Columbia, SC
csccat	Computer Support Corporation	Texas
csdev	Challenger Software	Homewood, Illinois
cshub	San Francisco State University	San Francisco, CA
csi	Communications Solutions Inc., Softw	San Jose, CA
csibtfr	Condor Systems, INC.	San Jose, CA
csn	Colorado SuperNet Inc	Golden, Colorado
csuchico	California State University, Chico	California
csuf3b	Department of Computer Science, Cali	Fresno, California
csufres	Department of Computer Science, Cali	Fresno, California
csuh	California State University, Hayward	Hayward, CA
csula-ps	California State University, Los Ang	Los Angeles, CA
csun	California State University, Northri	Northridge, CA
csusac	California State University, Sacrame	Sacramento, CA
csustan	California State University, Stanisl	California
ctdi1	Communications Test Design, Inc.	West Chester, PA
cti	Cornerstone Technology, Inc.	Sunnyvale, CA
ctmsd2	City of Toronto Management Services	Canada
ctnews	Convergent Technologies	San Jose, CA
ctsj	Unisys/Convergent San Jose Sales Off	San Jose, CA
cucard	Columbia University, College of P &	New York City, NY
cucstud	Columbia Union College, Math Science	Takoma Park, MD
cuok	Cameron University	Lawton, Oklahoma
cutsys	Paul's Auto Imports	Oregon
cvedc	Prime/Computervion ECAE Development	Beaverton, Oregon
cvl	Center for Automation Research, Univ	College Park, MD
cwi	Caseware, Inc.	Costa Mesa, CA
cwjcc	Case Western Reserve Univ. Jennings	Cleveland, Ohio
cybvax0	Cybermation, Inc.	Medford, MA
dacom1	Data Communication Co.	Korea
daisy	Daisy/Cadnetix -- An Intergraph Comp	Sunnyvale Californ
daitc	Defense Applied Information Technolo	Alexandria, VA
dale	Titan Linkabit Corp.	San Diego, CA
dalsil	Summer Institute of Linguistics - Da	Dallas Texas
dalsqnt	Sequent Computer Systems, Inc.	Dallas, Texas
danger	Hull Trading Co.	Chicago, Illinois
darth	Darth Software	Allison Park, PA
dartvax	Dartmouth College, Kiewit Computatio	Hanover, NH
das13	Snide Inc.	Folcroft, PA
dasys1	The Big Electric Cat	New York, New York
dataco	Canadian Marconi Company, DataComm	Canada
datacube	Datacube Inc.	Peabody, MA
daysinns	Days Inns of America	NE Atlanta, GA
dayton	Department Store Division of Dayton	Minneapolis, MN
dayvb	Science Applications International	Ohio
dazixca	Dazix -- An Intergraph Company	Mountain View, CA
dbi	ana-systems, inc.	Foster City, CA
dbk	Custom Solutions	Emerson, NJ
dcatla	Digital Communications Associates	Alpharetta, GA
dcdwest	ITT Defense Communications Division	San Diego, CA
dcfcen	Buenos Aires Univ.,Facultad Ciencias	Argentina
dcrlg5	Defense Contract Administration Serv	San Bruno, CA
dcs	DSC edv systemtechnik GmbH	Germany
dds	Digital Data Systems, Inc.	Fort Lauderdale FL
ddsw1	Macro Computer Solutions, Inc. / MCS	Chicago, Illinois
decide	Decisions, Decisions!	California
decuac	Digital Equipment Corp., Software Se	Landover, MD
decvax	Digital Equipment Corporation	Nashua, NH
decwrl	Digital Equipment Corporation, Weste	Palo Alto, CA
deincr	Delker Electronics, Inc.	US Mail
delbr	The Jarrett Family	La Mesa, CA
denwa	Info Connections	West Los Angeles C
depot	Kansas State University Dept. of Com	Manhattan, Kansas
desint	Interrupt Technology Corporation	Manhattan Beach CA
desktech	Deskstation Technology, Incorporated	Kansas
destroyer	The University of Michigan, Informat	Ann Arbor, MI
dev	Defense Technical Information Center	Alexandria, VA
devcom	Devcom Mid-America, Inc.	Oak Brook, IL
develop	Ministerio de la Funcion Publica	ARGENTINA
dg-rtp	Data General Corp.	Research Triangle
dgcad	Data General Corporation, SDD	Sunnyvale, CA
dgis	Defense Technical Information Center	Alexandria, VA
dhump	Nubeat Communications	Wisconsin
digi	DSC Communications	Plano, Texas
digibd	Digi Board	St Louis Park, MN
diogenes	Operating Systems Engineering Corpor	La Honda, CA
discg1	Defense Industrial Supply Center	Philadelphia, PA
discrs	DISC ACCESS Products Group, Inc.	Georgia
disk	Digital Information Systems of Kentu	Louisville, KY
ditka	Chicago Software Works	Menlo Park, CA
dkstar	Jon Bennett	Lawrenceville, GA
dkuug	DKUUG - Dansk UNIX-system Bruger Gru	K|benhavn \
dlag1	HQ U. S. Defense Logistics Agency/DL	Alexandria, VA
dlb	D. L. Buck and Associates, Inc.	San Jose, CA
dlogics	Datalogics, Inc.	Chicago, Illinois
dlscg1	Defense Reutilization and Marketing	Michigan
dlscg2	Defense Logistics Services Center	Michigan
dlscg3	Defense Logistics Services Center	Michigan
dlss2	Southwestern Bell Telephone Co.	Dallas, Texas
dmk3b1	David Keaton (individual)	Branford, CT
dmntor	Digital Media Networks Inc.	Canada
dms1	Dawnlee Management Systems	Lyndhurst
dms3b1	Infotouch Systems, Inc.	Bedford, Texas
dmsd	DMS Design	San Luis Obispo CA
dogcow	Alisa Systems, Inc.	Pasadena, CA
dorothy	Joe Stong Software	San Francisco, CA
doulos	EES Inc./Doulos Publishing	Dallas, Texas
dpdvax	Data Processign Design	Anaheim, CA
dpmizar	Datapoint Corporation, Product Devel	San Antonio, Texas
dptcdc	Datapoint Corporation, Canadian Deve	Canada
dptspd	Datapoint Corporation	San Antonio, Texas
dragon	Computer Projects Unlimited	Tucker, Georgia
dragos	Hewlett Packard	CANADA
drbear	Drummer Bear Systems	Menlo Park, CA
drd	DRD Corporation	Tulsa, Oklahoma
drexel	Drexel University, Electrical & Comp	Phila, PA
drilex	DRI/McGraw-Hill	Lexington, MA
dropte	Intel Corporation, OMO Software Engi	Hillsboro, Oregon
druid	D'Arcy Cain Consulting	Ontario
dsac	U. S. Defense Logistics Agency Syste	Columbus, Ohio
dsacg1	U. S. Defense Logistics Agency Syste	Columbus, Ohio
dsachg1	DLA Systems Automation Center	Ogden, Utah
dsacng1	Defense Systems Automation Center No	Michigan
dscatl	Digital Systems Company, Inc.	Duluth, Georgia
dscvax2	Digital Sound Corporation	Santa Barbara, CA
dse	Ampex Corporation, Design Support En	Colorado
dsinc	Datacomp Systems, Inc.	Huntingdon Valley
dspvax	MIT Digital Signal Processing Group	Cambridge, MA
dsw	Data Systems West	Sherman Oaks, CA
dticg1	Defense Technical Information Center	Alexandria, VA
dtscp1	Digital Transmission Systems	Duluth, Georgia
dtseng	DTS Engineering & Consulting	Hudson, NH
duboce	AIDS Information Development System	San Francisco, CA
dukcds	Center for Demographic Studies, Duke	Durham, NC
duke	Duke University Department of Comput	N C
dukeac	Center for Academic Computing, Duke	North Carolina
dumbcat	MH Software	Hayward, CA
dungeon	MCP Systems	Richardson, Texas
dunike	University of Denver	Denver, Colorado
durin	SPARTA, Inc, Laguna Hills Operation	Laguna Hills, CA
dvinci	University of Saskatchewan, College	Canada
dvlmarv	Develcon Electronics Ltd.	Ontario
dwon	Center for Information Technology In	Ann Arbor, MI
dybbuk	Telerate Canada Inc.	Canada
dynasys	Dynasys	Memphis, Tennessee
dyndata	Dynamic Data and Electronics	Edmonds, WA
eakins	Eakins Associates	Mountain View, CA
earvax	Eaton-Peabody Laboratory of Auditory	Massachusetts
eastern	Public Affairs Services	Toronto Ontario Ca
ecicrl	Elegant Communications, Inc.	Canada
ecijmm	Elegant Communications, Inc.	Canada
eclectic	Eclectic Systems	Canada
ecord	Ministerio de la Funcion Publica	ARGENTINA
ecsgate	UNC Educational Computing Service	Research Triangle
ecsvax	UNC Educational Computing Service	Research Triangle
edinboro	Edinboro University of PA.	Edinboro, PA
edm	Unexsys systems inc.	Can
ednor	Boston Business Computing, Ltd.	Lawrence, MA
eds1	Senate of Pennsylvania	Main Capitol Bldg
edsews	Electronic Data Systems	Troy, Michigan
edsi	Enterprise Data Systems Incorporated	Appleton, WI
edsr	EDS Advanced Research	Dallas, Texas
eecae	Mich. State Univ., Engineering R &	E Lansing, MI
eedsp	School of Electrical Engineering	Atlanta, Georgia
eeg	EEG Systems Laboratory	San Francisco, CA
efccim	Electrofusion Corporation	Fremont, CA
efceng	Electrofusion Corporation, Engineeri	Fremont, CA
egg-id	Idaho National Engineering Laborator	Idaho Falls, Idaho
egrunix	Oakland University	Rochester, MI
egsner	Central Iowa (Model) Railroad	Plano, Texas
eiger	Institut fuer Integrierte Systeme,	Switzerland
elan	Elan Computer Group, Inc.	Mountain View, CA
elandes	ELAN designs	Saratoga, CA
electro	Electrohome Electronics	Canada
elektro	C and J Systems	Gahanna Ohio
elgar	Elgar Corporation	San Diego, CA
ellery	Ellery Systems, Inc.	Boulder, Colorado
elrond	CalComp Inc., A Lockheed Company	Hudson, NH
elroy	Image Analysis Group, Image Processi	Pasadena CA USA
elsie	National Institutes of Health	Bethesda, MD
emcard	Emory University Cardiac Data Bank	Atlanta, Georgia
emg	Technology Resource Center	LA, California
emily	University of Vermont, Division of	Burlington, VT
emory	Math and Computer Science, Emory Uni	Atlanta, Georgia
emoryu1	Computing Center, Emory University	Atlanta, Georgia
emunix	Eastern Michigan University, Univers	Ypsilanti, MI
encore	Encore Computer Corporation	Marlborough, MA
enea	Enea Data AB	Sweden
engvax	Hughes Aircraft Co., Space & Communi	Los Angeles, CA
enky	Enkys	Portland, Oregon
entire	Entire Inc., Engineering Center, Wes	New York
enuucp	Arizona State University, Engineerin	Tempe, Arizona
epds01	Ford Motor Company	Dearborn, Michigan
epiwrl	Entropic Processing, Inc.	Washington, DC
eplunix	Eaton-Peabody Laboratory of Auditory	Massachusetts
epochsys	Epoch Systems, Inc.	Westboro, MA
ericom	Ericsson Telecom AB	Sweden
ermhs	Computer Technology Institute (cti)	Greece
ernest	Texas Instruments	Plano, Texas
ernie	Digital Source, Inc., San Diego CA	SD, California
errante	Ministerio de Relaciones Exteriores	ARGENTINA
esc-bb	Eclipse Systems Corporation	Texas
esca	ESCA Corporation	Bellevue, WA
escargot	Coredump Central	Beaverton, Oregon
eskimo	Eskimo North	Seattle, WA
esosun	Science Applications International	Mail Stop
esprit	/dev/null Software	Samta Ana, CA
esquire	Davis Polk & Wardwell	New York
estad	Ministerio de la Funcion Publica	ARGENTINA
esther	Advanced Computer Consulting, Inc	Charlottesville VA
esunix	Evans & Sutherland Computer Corporat	Salt Lake City, UT
ethos	Humanities Forum Network	Gray, Tennessee
ethz	Kommunikationssysteme, ETH Zuerich	Switzerland
etrivax	Electonics and Telecommunication Res	Korea
eurynome	eurynome	Grand Rapids, MI
exc	Exceptions	Hillsboro, Oregon
excelan	Novell Corp.	San Jose, CA
execu	Comshare - Austin Dev Center	Austin, Texas
faatcrl	Federal Aviation Administration	Atlantic City Inte
fai	Fujitsu America Inc.	San Jose, CA
fantasci	Fantasci Incorporated / Fantasci Gam	Edgewater Park, NJ
farcomp	Farallon Computing Inc.	Emeryville, CA
farside	Calyx Corporation	Brookfield, WI
fasfax	Fasfax Corporation	Nashua, NH
fdurt1	Fairleigh Dickinson University	Madison, NJ
fed	Board of Governors of the Federal Re	Washington, DC
feith1	Feith Systems & Software, Inc.	Fort Washington PA
feline	Humber College, Technology Division,	Canada
felix	FileNet Corporation	Costa Mesa, CA
fernwood	Anterior Technology	Menlo Park, CA
fibers	Allied-Signal Corporation	Petersburg, VA
ficc	Ferranti International Controls Corp	Sugar Land, Texas
fico	The Fair, Isaac Companies	San Rafael, CA
firefly	Firefly Enterprises	Lake Oswego, OR
fishnet	M-net	Miami Bch, Florida
fiver	Fiver Communications	Santa Clara, CA
fix	Fenris Computer Services, Inc.	Corvallis Oregon
flkvax	XED Software Systems	Chatsworth, CA
fluke	John Fluke Manufacturing Co., Inc.	Everett, WA
flying	Flying Disk Systems, Inc.	Los Angeles, CA
fmeed1	Ford Motor Company, Electronics Divi	Dearborn, Michigan
fmsrl5	Ford Motor Company, Scientific Resea	Dearborn, Michigan
fmsrl7	Ford Motor Company, Scientific Resea	Dearborn, Michigan
fmsrlx	Ford Motor Company, Scientific Resea	Dearborn, Michigan
fmsystm	F M Systems, Inc.	Ohio
fnx	I/Ovations	USA
foobar	Intel Micro-Systems Operation	Hillsboro, Oregon
force	Force Technology Corporation	San Jose, CA
formtek	Formtek	Pittsburgh, PA
fortune	SCI/Fortune Systems	San Carlos, CA
foxpv2	BCT Systems	San Jose, CA
foxtail	The Foxtail Group	Ramona, California
fpssun	FPS Computing	Portland, Oregon
frackit	Data Factory Services	Harrisburg, PA
frame	Frame Technology Corporation	San Jose, CA
franz	Franz Incorporated	Berkeley, CA
frcs	free range computer systems cc	South Africa
frith	Michigan State University, College	E Lansing, MI
frmug	Minix User Group France	France
frye	Frye Electronics, Inc.	Tigard, Oregon
fryepro	Frye Electronics, Inc., Tigard	Tigard, Oregon
fsg	Fusion Systems Group	New York, New York
fub	Freie Universitaet Berlin, FB Chemie	Germany
fulano	Ministerio de Relaciones Exteriores	ARGENTINA
futures	Commodity Futures, Inc.	Woodside, CA
g73	Biology Department, Boston College	Chestnut Hill, MA
gab100	Gable Group Inc.	San Diego, CA
gacc	Command Corp Inc.	Duluth, Georgia
gagme	GAGME Public Access UNIX System	Chicago, Illinois
galaxia	Galaxia Computer Systems	Portsmouth, RI
galaxy	Rutgers Univ., Center for Computer	Newark, New Jersey
galbp	Harris Corporation, Lanier Business	Atlanta, Georgia
gallium	MCS Associates	Tarrytown, NY
ganglion	D.J. Services	Michigan
garam	Data Communicatins Corps. of Korea	ga
garfield	Memorial University of Newfoundland,	Canada
gargoyle	University of Chicago	Chicago, Illinois
garth	Intergraph (APD)	Palo Alto, CA
gate	Elegant Communications Inc.	Canada
gatech	School of Information and Comp. Sci.	Atlanta, Georgia
gdfwc3	General Dynamics, Fort Worth Divisio	Fort Worth, Texas
gedphx	Allied-Signal Aerospace, Garrett Eng	Phoenix, Arizona
gemini	Computer Consoles Inc., CPD, Advance	Irvine, California
genco	Gentry & Associates	Excelsior Springs
genesis	Macro Computer Solutions, Inc. / MCS	Chicago, Illinois
genisco	Genisco Technology Corp.	Anaheim, CA
genrad	GenRad, Inc.	Concord, MA
genuke	General Electric Nuclear Energy	San Jose, CA
geopaz	University of Wisconsin, Dept. of Ge	Madison, Wisconsin
geops	Geophysics, Univ. of Washington	Seattle, WA
geowhiz	University of Wisconsin, Dept. of Ge	Madison, Wisconsin
ghsvax	Green Hills Software, Inc.	Santa Barbara, CA
giga	Unisys	Utah
ginosko	Samsung Software America, Inc.	Andover, MA
givc	General Instrument VideoCipher Divis	San Diego, CA
gladys	David Dalton, Writer/Editor	San Francisco, CA
glc	George L. Chisa	Rochester Hills MI
glinj	General Logistics International, Inc	Union, New Jersey
gmeeca	General Motors Electrical Engineerin	Milford, Michigan
gna	Association GNA	Paris France
golem	S-Cubed	San Diego, CA
gonzo	Gonzo Media Group	San Francisco, CA
gordius	Gordian	Santa Ana Heights
gould9	Encore Computer Corporation	San Diego, CA
gozer	McBride Software Consulting Group,	Nashua, NH
grayhawk	Mustang Electronics	Des Moines, Iowa
grebyn	Grebyn Corporation	Vienna, Virginia
grex	Cyberspace Communications, Inc.	Ann Arbor, MI
grian	College Park Software	Altadena, CA
griffin	University of Vermont, Division of	Burlington, VT
grinch	Textural Software	San Jose, CA
gryphon	TE Technology	Carson, California
gsg	General Systems Group, Inc.	Salem, NH
gssc	Graphic Software Systems	Beaverton, Oregon
gsy1	Yates Pest Control, Inc. and Delker	US Mail
gt-cmmsr	Center for Human-Machine Systems Res	Atlanta, Georgia
gt-eedsp	School of Electrical Engineering	Atlanta, Georgia
gtenmc	GTE Telecom, Inc. Bothell	SE Bothell, WA
gtephx	AG Communication Systems	Phoenix Arizona
gtisqr	Maverick International Inc.	Mukilteo, WA
gtx	GTX Corporation	Phoenix, Arizona
gumby	Western Michigan University	Kalamazoo, MI
gungnir	Fenris Computer Services, Inc.	Corvallis Oregon
guti	Hospital General de Ni#os "Ricardo	Argentina
guug	German UNIX Systems Users Group	Gerrmany
gvls1	Paramax Systems (A Unisys Co.), Grea	Paoli, PA
gvlv2	Unisys Corporation, Great Valley Lab	Paoli, PA
gw3com	3Com Corporation	Santa Clara, CA
gwinnett	Gwinnett Computer Services	Duluth, Georgia
gwusun	The George Washington University	Washington, DC
haapi	Haapi's Hangout (Drivers 'R Us)	Minnetonka, MN
haberfellner	Eric's Place	Ontario
hacgate	Hughes Aircraft Company, Space and	Los Angeles, CA
hackbox	CMP Publications et al	Land
hadron	EIS Division, Hadron, Inc.	Fairfax, Virginia
hal6000	Tandy Systems Software	Ft Worth, Texas
halcyon	The 23:00 News	Grapeview, WA
halfdome	Bob Pasker, Software and Communicati	San Francisco, CA
hall	Cray Research, Inc.	Mendota Heights MN
halla	Data Communications Corps. of Korea	ga
halley	Tandem Computers (MPD)	Texas
happym	Happy Man Corporation	Seattle, WA
harker	Harker Systems	San Jose, CA
harper	William Rainey Harper College	Palatine, Illinois
harry	Kansas State University Dept. of Com	Manhattan, Kansas
harvard	Harvard University, Division of Appl	Cambridge, MA
harvax	Ready Systems Inc.	Sunnyvale, CA
hbiso	Honeywell Bull - Indirect Sales Oper	Waltham, MA
hc	Los Alamos National Laboratory -- ME	Los Alamos, NM
hcfeams	ARSB Support Group	b
hcr	HCR Corporation	Canada
hcx1	Harris Corp., Computer Systems Divis	Fort Lauderdale FL
heifetz	MSEN, Inc.	Ann Arbor, MI
helps	Howard Electronics Laboratories, Pro	Austin, Texas
herman	Unisys Coporation	Eagan, Minnesota
hermesa	Hermes & Associates	Bellevue, WA
hermix	Mark V Systems Limited	Encino, California
hern	Stonemarche Network CoOp	Greenfield, NH
hernix	Michael A. Herman Software	Strongsville, Ohio
heurikon	Heurikon Corporation	Madison, Wisconsin
hhb	Racal-Redac	Mahwah, New Jersey
hico2	High Country Software	Red Bank, NJ
hippo	InterPractice Systems	San Francisco, CA
hitachi	Hitachi America - Semiconductor & IC	Brisbane, CA
hjuxa	Digital Equipment Corporation	Manalapan, NJ
hlborl	home	Orlando, Florida
hodge	Hodge Computer	Orange, California
holos0	Holos Software, Inc.	Tucker, Georgia
holston	Barton A. Fisk & Co., Inc.	Lake Charles, LA
homecare	Health Sphere of America Inc.	Memphis, Tennessee
homer	Tailored Software, Inc.	Wheaton, Illinois
homero	Ministerio de Relaciones Exteriores	ARGENTINA
homey	RedRock Development	Garland, Texas
hoptoad	Nebula Consultants	USA
horong	Data Communicatins Corps. of Korea	ga
hotlips	TSM Computing Group	Ann Arbor, MI
hourglas	The Hourglass UNIX Box	Ridgewood, NJ
hp-col	Hewlett-Packard Colorado Springs	Colorado Springs C
hp-lsd	Hewlett-Packard Company, Logic Syste	Colorado
hp-pcd	Hewlett-Packard Co., Corvallis, Oreg	Corvallis, Oregon
hp-sdd	Hewlett-Packard Company, San Diego	San Diego, CA
hp1	Hollister Incorporated	Libertyville, IL
hp4at	EUnet EDV Dienstleistungs GmbH	Austria
hpcea	Hewlett-Packard Company	Palo Alto, CA
hpda	Hewlett-Packard Networked Systems Gr	Cupertino, CA
hpfcla	Hewlett-Packard, Fort Collins Site	Colorado
hpiag0	Hewlett-Packard Company	Cupertino, CA
hpiagoa	Hewlett-Packard Company	Cupertino, CA
hplabs	Hewlett-Packard Laboratories, Resear	Palo Alto, CA
hplabsy	Hewlett-Packard Laboratories, Comput	Palo Alto, CA
hplsla	Hewlett-Packard Lake Stevens Instrum	Wa USA
hpubvwa	Hewlett-Packard Bellevue Sales Offic	Bellevue, WA
hpupora	Hewlett-Packard Wilsonville Sales Of	Wilsonville, OR
hpuslma	Hewlett Packard, St. Louis	St Louis, Missouri
hqda-ai	US Army Artificial Intelligence Cent	Washington, DC
hrc	Handwriting Research Corporation	Phoenix, Arizona
hrshcx	Harris Computer Systems	Fort Lauderdale FL
hscfvax	Harvard University, School of Public	Boston, MA
hsi	3M Health Information Systems	Wallingford, CT
hslrswi	Ascom Hasler AG	Switzerland
hubinf	Humboldt-Universitaet, Sektion Infor	Germany
huji	The Hebrew Univ. of Jerusalem, Dept.	Israel
humu	Naval Ocean Systems Center, Hawaii	San Diego, CA
humus	The Hebrew Univ. of Jerusalem, Dept.	Israel
humvax	Humber College, Technology Division,	Canada
huron	Huron Systems	Ann Arbor, MI
husc6	Harvard University, Science Center	Cambridge, MA
hutch	Rabbit Software Corporation	Malvern, PA
hybrid	The Home for Undeployed Basselopes	Canada
i2unix	Dipartimento di Informatica, Sistemi	Italy
ibism	Citibank, N.A.	New York, New York
ibmcan	IBM Support Centre, IBM Canada Limit	Markham Ontario
ibmorl	IBM Orlando Customer Center	Florida
icc	Intercomputer Communications Corp.	Ohio
icdi10	The House of Rump	Beverly, NJ
ice	University of Wisconsin, Dept. of Ge	Madison, Wisconsin
ichips	Intel Corporation	Hillsboro, Oregon
icldata	ICLDatachecker System Inc.	Santa Clara, CA
ico	Interactive Systems Corporation	Boulder, Colorado
icus	ICUS Software Systems	Austin, Texas
iczer-1	The Kurowulf Empire	Clifton, NJ
idacom	IDACOM Electronics Ltd.	Canada
idc	InfoDesign Corporation	Toronto, Ontario
ide	Interactive Development Environments	San Francisco, CA
idgeast	SunWorld	Peterborough, NH
idis	University of Pittsburgh SLIS Labora	Pittsburgh, PA
iex	IEX Corporation	Texas
igloo	Small Computer Users Magazine	Northbrook, IL
igor	Rational	Santa Clara, CA
ihf1	Intel Corporation, DTO Engineering	Hillsboro, Oregon
iis	Institut fuer Integrierte Systeme,	Switzerland
iisat	International Information Service	Canada
iitmax	Illinois Institute of Technology	Chicago, Illinois
ileaf	Interleaf Inc.	Cambridge, MA
illian	Micronetics, Aloha Research Group	Oregon
imag	Institut d'Informatique et de Mathem	France
imagen	Imagen Corp.	Santa Clara, CA
imax	Imax Corporation	Ont Canada
imp	1OA Inc.	N Potomac, MD
impch	ImproWare Computersysteme	Fuellinsdorf
implode	Delta Systems International	Gresham, Oregon
ims	Integrated Measurement Systems, Inc.	Beaverton, Oregon
incom	INCOM, Interessengemeinschaft Comput	Germany
incstar	INCSTAR Corp	Stillwater, MN
indep1	Software Services, Inc.	Addison, Illinois
indetech	Independence Technologies	Fremont, CA
indigo	Mese Software	Atlanta, Georgia
indogtw	University of Indonesia, Computer Sc	Indonesia
indri	University of Wisconsin, Wisconsin	Madison, Wisconsin
inesc	Instituto de Engenharia de Sistemas	LISBOA CODEX PORTU
infbs	TU Braunschweig, Institute fuer Info	Germany
infinet	Teleglobe Communications, Inc.	North Andover, MA
infmx	Informix Software, Inc.	Menlo Park, CA
infopro	InfoPro Systems	Rescue, California
infor	Ministerio de la Funcion Publica	ARGENTINA
infoserv	InfoServ Connections (tm)	Los Gatos, CA
infoswx	IEX Corporation	Texas
ingres	ASK Computer Systems/Ingres Product	Alameda, CA
inland	Inland Steel Research Labs	East Chicago, IN
inmet	Intermetrics, Inc	Cambridge, MA
inria	Institut National de Recherche en In	France
insyte	Innovative Systems Techniques	Newton, MA
intacc	Inter/Access	Canada
intek01	Intek	Bellevue, WA
intelca	Intel Corp., Santa Clara Microproces	Santa Clara, CA
intelhf	Intel Corporation, Development Tools	Hillsboro, Oregon
interex	INTEREX The HP International Users	Sunnyvale, CA
interlan	Interlan, Inc., UNIX Development Gro	Boxborough, MA
intermec	Intermec Corporation	Wa USA
intersil	Harris Semiconductor Data Acquisitio	Santa Clara, CA
inthap	Intel Corporation (Sales)	Islandia, New York
introl	Introl Corp.	Milwaukee, WI
intsc	Intel, North West Sales Region	Santa Clara, CA
inttech	Interactive Technology, Incorporated	Beaverton, Oregon
iog	International Investment Group, Inc.	Port Chester, NY
ipars	Spectrum Data Services	Carlsbad, CA
ipc	IPC Pension Services Company, Inc.	Seattle, WA
iphasew	Interphase West	Santa Clara, CA
iquery	IQ Software Corporation	San Antonio, Texas
iros1	Dept. IRO, Universite de Montreal	Quebec
irs3	Internal Revenue Service - Informati	Washington, DC
irscscm	Internal Revenue Service, Computer	Washington, DC
irsx01	Internal Revenue Service - Informati	Washington, DC
isagate	Integrated Systems Applications Corp	Alberta
isc-br	ISC-Bunker Ramo, An Olivetti Company	Liberty Lake, WA
iscuva	ISC Systems Corporation	Liberty Lake, WA
isg100	Information Systems Group Inc.	San Diego, CA
isidoro	Ministerio de Relaciones Exteriores	ARGENTINA
isieng	Integrated Solutions, Inc.	San Jose, CA
isis	U. of Denver, Dept. of Math and Comp	Denver, Colorado
islabs	Integrated Solutions, Inc.	Hillsboro, Oregon
island	Island Graphics Corporation	San Rafael, CA
islenet	Islenet Inc.	Honolulu, Hawaii
ism	Interactive Systems Corporation	Los Angeles, CA
ism780	Interactive Systems Corporation, San	Santa Monica, CA
ism780c	Interactive Systems Corporation	Santa Monica, CA
isrnix	Indiana University, Institute for So	Bloomington, IN
ists	Institute for Space and Terrestrial	Canada
itcatl	DISC ACCESS Products Group, Inc.	Georgia
itcyyz	Reuters Information Services	Canada
itivax	The Industrial Technology Institute	Ann Arbor, MI
iuvax	Indiana University Computer Science	Bloomington, IN
ivucsb	QuickSilver Rallye Team, Santa Barba	Santa Barbara, CA
iwblsys	Intel Corp., West Bloomfield, Michig	West Bloomfield MI
jabber	Bux Technical Services	Doylestown, PA
jack	Systems'n'Software	Fremont, CA
jackknife	Statisics and Operations Research,	Princeton, NJ
jandel	Jandel Scientific Corp.	Corte Madera, CA
jando	Independent Consultant	Springfield, VA
jarsun1	Jordan Apostal Ritter Associates	North Kingstown RI
jartel	Jartel, Inc.	San Diego, CA
jarthur	Harvey Mudd College	Claremont, CA
jato	JPL, Communications and Computing Ne	Pasadena, CA
jc3b21	St. Petersburg Junior College	St Petersburg, FL
jc3b22	St. Petersburg Junior College	St Petersburg, FL
jc3b23	St. Petersburg Junior College	St Petersburg, FL
jcc-one	Jones & Jones / Jones Technologies	Sterling, Colorado
jcnpc	Homebrew Virtual Reality Labs	Columbus, Ohio
jdbbs	JD's Connection	Jenison, Michigan
jdpsys	JDP Computer Systems Inc.	Ontario
jetson	SMART HOUSE Limited Partnership	Upper Marlboro, MD
jfwhome	Funhouse Consultants	Somerville, MA
jho	Software Programming, Inc.	Richardson, Texas
jmegen	UCLA Dept. of Neurology / VA Wadswor	Los Angeles, CA
johnny5	J5 Research	Bothell, WA
jolnet	jolnet, Public Access UNIX, Joliet,	New Lenox, IL
joshua	FoxPro database design	Texas
jplgodo	Jet Propulsion Laboratory, Advanced	Pasadena, CA
jplpro	Jet Propulsion Laboratory, Space Fli	Pasadena, CA
jplpub1	JPL, Communications and Computing Ne	Pasadena, CA
jpradley	Unix in NYC	New York, New York
jpunix	J.P. and Associates	Dickinson, Texas
jtsv16	JTS Computer Systems Ltd.	Canada
jungfrau	Dezentrale Informatikdienste (ZIR),	Switzerland
junska	RWI / J & J Productions	Norwood, NJ
jup	Tristan Debeaupuis	France
jvncnet	JvNCnet	Princeton, NJ
jwt	John W. Temples, III	Orlando, Florida
jyacc	JYACC, Inc.	New York, New York
ka2qhd	KA2QHD Ham Radio Related & general	Ocean, New Jersey
ka3ovk	Internal Revenue Service, Informatio	Washington, DC
kadmon	Vennerable Consulting	Albany, California
kakwa	University Of Alberta, Computing &	Alberta
kangaro	Kangaroo Koncepts, Inc.	Indiana USA
kass	Saratoga Information Systems	Saratoga, CA
kelvin	S-Cubed	San Diego, CA
kenobi	Omnicron Data Systems	West Chester, PA
kepler1	Renaissance Technologies Corp.	Setauket, New York
kericks	Erickson Engineering	Lombard, Illinois
kerner	The Kerner Company	San Rafael, CA
ketri	Electronics and Telecommunications	Korea
key	Key Computer Laboratories	Fremont, CA
kf5iw	Honda Sport Touring Association	Dallas, Texas
ki4pv	CompuData, Inc.	DeLand, Florida
ki4xo	Tridom Corporation	USA
kicah	KICAH (Rejean Payette)	Canada
kiet	Electronics and Telecommunications	Korea
killer	Guido's Public Access	Portland, Oregon
kinetics	Novell, Inc.	California
kira	University of Vermont, Division of	Burlington, VT
kit	Korea Institute of Technology	Korea
kit0	Korea Institute of Technology	Korea
kitenet	Kite-Net LTD.	Kirtland Ann Arbor
kitty	Recognition Research Corp.	East Amherst, NY
kksys	K and K Systems	Plymouth, MN
kmjhome	Online Systems	Lawton, Oklahoma
kneller	There ain't no organization here.	Canada
kolvir	Friends Of The Don-Buddah	Seattle, WA
koosh	OMNI Solutions	Los Altos, CA
kosman	Vital Software Services, Channel Isl	Channel Islands CA
kpc	Kubota Pacific Computer Inc	Santa Clara, CA
krafla	University of Iceland, Computing Cen	Iceland
ks25	R. R. Donnelley & Sons Company	Lisle, Illinois
ksala	SanSoft Inc.	Torrance, CA
ksgbbs	Kennedy School of Government/Harvard	Cambridge, MA
ksuvax1	Kansas State University Dept. of Com	Manhattan, Kansas
kulcs	Katholieke Universiteit Leuven, Depa	Belgium
kumr	Late Night Software	San Francisco, CA
kyzyl	Somewhere in Royal Oak	Michigan
lad-shrike	Lockheed Missles & Space Co., Austin	Texas
ladcgw	Bull HN Information Systems Inc.	Los Angeles, CA
laidbak	INTERACTIVE Systems Corporation Nape	Naperville, IL
lakart	Lakart Corporation, Newton	Newton, MA
lakesys	Lake Systems	Wisconsin
lamc	Letterman Army Medical Center - Dept	Presidio of San Fr
lanl	Los Alamos National Laboratory	Los Alamos, NM
larkint	Sun Microsystems, Portland Oregon	Aloha, Oregon
latour	Sandelman Software Works	Ottawa, Ontario
laurel	Broward Community College	Davie, Florida
leafusa	Interleaf, Inc.	Waltham, MA
lecgwy	Lockheed Electronic Company, Inc.	Plainfield, NJ
lecvae	Lockheed Electronic Company, Inc.	Plainfield, NJ
legal	Censtor Corp.	Santa Clara, CA
legato	Legato Systems, Inc.	Palo Alto, CA
legs	AST Research, Inc.	Irvine, California
lehi3b15	Lehigh University, Computer Science	Bethlehem, PA
lemuria	Shecora Assocates Inc	Brookline, NH
leo	Computer Consoles Inc., CPD, Advance	Irvine, California
lethe	Systems Software	Canada
letni	LawNet	Sarazen Mesquite T
lever	Lever Industries	San Francisco, CA
lexicon	Lexicon, Inc.	Waltham, MA
lgnp1	Lagniappe Systems	Norristown, PA
liberty	Sun Microsystems Inc, King of Prussi	King of Prussia PA
light	Light Systems	Mountain View, CA
lilink	Lilink Communications	Valley Stream N Y
lily	Unisys Corporation	Eagan, Minnesota
limbic	Southwest Systems Development Labs	Houston, Texas
limbo	Intuitive Systems	Mountain View, CA
limerick	Stupid Puns Inc.	Illinois
linac	Fermi National Accelerator Laborator	Batavia, Illinois
littlei	Intel Corp., IMSO UNIX Software, Hil	Oregon
ll-xn	MIT Lincoln Laboratory	Lexington, MA
lll-crg	Lawrence Livermore National Laborato	Livermore, CA
lll-tis	Lawrence Livermore National Laborato	Pleasanton, CA
lll-winken	Lawrence Livermore National Labs	Livermore, CA
lln-cs	Universite Catholique de Louvain	Belgium
llustig	Greenwire Consulting	Palo Alto, CA
lock60	Schuylkill Canal Association	Mont Clare, PA
loft386	Lofty Pursuits	Rapid City, SD
logico	Logicon, Operating Systems Division	Marina del Rey, CA
logsysv	Logical Systems	Philadelphia, PA
lokkur	Inland Sea	Hidden Lake Circle
longbow	US Army Corps of Engineers, Sacramen	Sacramento, CA
looking	Looking Glass Software Limited	Canada
loop	Keith Lofstrom Integrated Circuits	Beaverton, Oregon
lotus	Lotus Development	Cambridge, MA
loyola	Comstock Connections	Austin, Texas
lpi	Liant Software Corporation	Framingham, MA
lri	CNRS, Laboratoire de Recherche en In	France
lrw	LRW Systems	Stamford, CT
lsican	LSI Logic Corporation of Canada, Inc	Etobicoke, Ontario
lsrhs	Lincoln-Sudbury Regional High School	Sudbury, MA
lupine	Network Computing Devices	Mountain View, CA
lynx	Lynx Real-Time Systems Inc.	Los Gatos, CA
m-net	M-Net Public Access Conferencing	Ann Arbor, MI
m2-net	Public Access Unix	Ann Arbor, MI
m2c	Massachusettes Microelectronics Cent	Westboro, MA
m2xenix	Pacific Systems Group	Oregon
mac	Parks College	Cahokia, Illinois
macom1	Centel Federal Systems, Inc.	Reston, Virginia
macomh	Centel Federal Systems, Inc.	Reston, Virginia
madhat	DataVision	Huntsville, AL
madnix	ARP Software	Madison, Wisconsin
magic	Evergreen Technology Group	Palo Alto, CA
magnus	The Hotline	California
mahendo	Jet Propulsion Laboratory, Advanced	Pasadena, CA
mailrus	Computing Center, The University of	Ann Arbor, MI
manapua	PUBNET Communications Services	Honolulu, Hawaii
mancol	Manhattan College	Riverdale, NY
manhat	Manhattan College	Riverdale, NY
mani	Korea Advanced Institute of Science	Republic of Korea
marcal	Marcal Systems Corporation	Cary, Illinois
marge	Ski Burrito Headquarters	Oaks, California
markets	American Information Exchange Corpor	Palo Alto, CA
mas1	Measurex Automation Systems	Cupertino, CA
masscomp	Concurrent Computer Corporation	Westford, MA
mathworks	The MathWorks Inc.	Cupertino, CA
matlab	The MathWorks, Inc.	South Natick, MA
matrox	Matrox Electronic Systems Ltd.	Canada
maxx	Tom Yager's UNIX Lab	Amherst, NH
mbf	MAI Systems Corporation	Tustin, California
mbsun	Mico	Oak Drive
mccall	The McCall Pattern Company	Manhattan, Kansas
mccc	Mercer County Community College	Trenton, NJ
mcdbos	Motorola, Microcomputer Division	Woburn, MA
mcdchg	Motorola, Microcomputer Division	Schaumburg, IL
mcdcup	Motorola Computer Group, Technical	Cupertino, CA
mcdham	Motorola, Semiconductor Products Sec	Wallingford, CT
mcdhup	Motorola, Technical Systems Division	Hauppauge, NY
mcdphx	Motorola Microcomputer Division	Tempe, Arizona
mcdurb	Motorola Microcomputer Division, Urb	Urbana, Illinois
mcf	Michigan Cancer Foundation	Detroit, Michigan
mcgill-vision	McGill University, McRCIM	Canada
mcgp1	McCaw Cellular Communications, Inc.	Kirkland, WA
mcl	Millions Computing Ltd.	Regina, SK
mcmi	Medical Computer Management Inc.	Omaha, Nebraska
mcrware	Microware Systems Corporation	Iowa
mcshh	HanseNet & NorthNet	Germany
mcspdx	Motorola, Inc., Computer Systems Div	Beaverton, Oregon
mcstul	MicroAge Computer Store, Tulsa OK	Tulsa, Oklahoma
mcsun	European Forum for Open Systems	Netherlands
mdbs	Micro Data Base Systems, Inc.	Lafayette, Indiana
mdcbbs	Electronic Data Systems, M & E Divis	Cypress, CA
mdf	Communications Network Solutions	Austin, Texas
mdhca	McDonnell Douglas Helicopter Company	Culver City, CA
mdi386	McIntyre Designs, Inc.	Langhorne, PA
mdisea	Motorola Inc., Mobile Data Division	Bothell, WA
mdlrth	Lockheed Electronic Company, Inc.	Plainfield, NJ
mdt	MDT, Inc.	Marietta, Georgia
meadow	Amdahl Canada Limited - Unix worksta	Canada
meccts	Minnesota Educational Computing Corp	North Minneapolis
medar	Medar, Inc. of Farmington Hills MI	Farmington Hills M
medea	MusicArt Associates	San Francisco, CA
medex2	University of Miami, Broward County	Ft Lauderdale, FL
medexam	University of Miami, Broward County	Ft Lauderdale, FL
media	Media Cybernetics, Inc.	Silver Spring, MD
medicus	Medicus Systems Corporation	Alameda, CA
megasys	Megasystems Inc.	Delray Beach, FL
mejac	Woodpecker Records Co.	Palo Alto, CA
men2a	Atlantic Rocket Corp.	Arlington, VA
merch	Radio Shack Computer Merchandising	Ft Worth, Texas
mergsun	Linotype Company	Hauppauge, NY
mergvax	Linotype Co.	Hauppauge, NY
merk	Darkside Systems	Boston, MA
mescal	Mescal Systems	Austin, Texas
meta4	Meta-4 Systems Corporation, R & D Di	Canada
metaware	MetaWare, Inc.	Santa Cruz, CA
metheus	Metheus Corporation	Oregon
metro	Metro Link Incorporated	Pompano Beach, FL
mfci	Multiflow Computer Inc.	Branford, CT
mfgsrvr	Microfield Graphics, Inc.	Beaverton, Oregon
mfocus	Micro Focus Inc.	Palo Alto, CA
mgse	mgse	Metairie, LA
mgweed	AT&T Montgomery Works	Montgomery, IL
mi-cec	Mellon Institute, Computer Engineeri	Pittsburgh, PA
mia	Tandy Radio/Shack Service	Coopercity, FL
miavax	University of Miami - Information Re	Coral Gables, FL
mibte	Michigan Bell Telephone Company	Southfield, MI
mic	RGL Consulting	Dallas, Texas
micor	M.B. Cormier INC.	Orleans, Ontario
microsoft	Microsoft	Redmond, WA
middco	Connecticut *nix Society	Canton, CT
midlyd	Lydia Soybeans, Inc.	South Carolina
mikros	Mikros Systemware / EDV-Beratung	Germany
milano	MCC Software Technology Program	Austin, Texas
miles	Miles Inc., Diagnostics Division	Elkhart, Indiana
milestn	Milestone R/D Labs	North Humboldt Mil
millipore	Millipore Corporation	Bedford, MA
mimsy	University of Maryland, College Park	College Park, MD
mindcrf	Mindcraft, Inc.	Palo Alto, CA
mini	home system	Belmont, CA
minist	Ministerio de la Funcion Publica	ARGENTINA
minuet	Open Minds Computing Solutions	Coloado Springs CO
minya	John Chambers' living room	Belmont, MA
mipos3	Intel Corp., Santa Clara Microproces	Santa Clara, CA
mips	Mips Computer Systems, Inc.	Sunnyvale, CA
mirror	Times Mirror Corporation	Cambridge, MA
mit-amt	MIT Media Lab	Cambridge, MA
mit-atrp	MIT Advanced Television Research Pro	Cambridge, MA
mit-caf	MIT Microsystem Tecnology Lab.	Cambridge, MA
mit-cipg	MIT Cognitive Information Processing	Cambridge, MA
mit-eddie	Massachusetts Institute of Technolog	Cambridge, MA
mit-nc	MIT Neural Computation Group	Cambridge, MA
mit-vax	MIT Laboratory for Computer Science	Cambridge, MA
mitech	Mitech Corporation	Concord, MA
mixcom	MIX Communications	Milwaukee, WI
mizarvme	Mizar, Inc.	Carrollton, Texas
mjbtn	JobSoft Design & Development Co.	US Mail
mks	Mortice Kern Systems Inc.	CANADA
mlfarm	Maple Lawn Farm	Stonington, CT
mmm	3M Company	St Paul, Minnesota
mmsac	Martin Marietta Data Systems	Sacramento, CA
mnetor	Motorola Computer X (CANADA) Ltd.	Ontario
mneuxg	Mnematics, Incorporated	Sparkill, New York
mntgfx	Mentor Graphics Corporation	Wilsonville, OR
mobdig	MobleDigital Corp.	Alameda, CA
mojave	Announcement Technologies	Helendale, CA
momenta	Momenta Corporation	Mountain View, CA
monarch	Array Microsystems, Inc	Colorado Springs C
moncol	Monmouth College Computer Services	W Long Branch, NJ
mongrel	A. Dunn Systems Corporation	Canada
monnet	Monmouth College Computer Services	W Long Branch, NJ
montagar	Montagar Software Concepts	Plano, Texas
monymsys	Mutual of New York	Teaneck, NJ
mordor	Lawrence Livermore National Laborato	Livermore, CA
morticia	Ministerio de Relaciones Exteriores	ARGENTINA
morton	Morton & Associates, Inc.	Tualatin, Oregon
moscom	Moscom Corporation	Pittsford, NY
motatl	Motorola, Inc. Computer Group, Techn	Atlanta, Georgia
motaus	Motorola Inc. Semiconductor Products	Austin, Texas
motbos	Motorola SPS	Woburn, MA
motcoh	Motorola Inc.	Worthington Ohio
motcsd	Motorola, Inc., Computer Group, Comm	San Jose, CA
motown	Allied-Signal, Inc., Corporate Headq	Morristown, NJ
motral	Motorola, Inc. Computer Group, Techn	Raleigh, NC
motsea	Motorola Semiconductor Products, Inc	Bellevue, WA
motsj1	Motorola Microcomputer Division	Sunnyvale, CA
motto	Motorola Canada, Ltd. Shared Systems	Canada
mottor	Motorola, Inc., Computer Group, Comm	Ontario
motwdc	Motorola MicroComputer Division	Columbia, MD
moundst	UUCP/Citadel Gateway System	Mound, Minnesota
mozart	Mark Galassi Research	Stony Brook, NY
mpx1	MPX Data Systems, Inc.	Pennsylvania
mri	Microtec Research Inc.	Santa Clara, CA
mrsmouse	Miller Rental & Sales	Ohio
mrspoc	Transact Software, Inc.	Sunnyvale, CA
msdc	Medical Systems Development Corp.	Atlanta, Georgia
mslbrb	Mike LeRoy	Santa Rosa, CA
mss	Mayfield Senior School	Pasadena, CA
mstan	Morgan Stanley & Co.	New York, New York
mstar	Morning Star Technologies, Inc.	Columbus, Ohio
mstr	Hartford Graduate Center	Hartford, CT
mtbaker	tfm Associates	Bellingham, WA
mtdiablo	Mt. Diablo Software Solutions	Concord, CA
mtek	MTEK International, Inc. / Throughpu	USA
mthvax	University of Miami - Dept. of Mathe	Coral Gables, FL
mti	Micro Technology, Inc.	Anaheim, CA
mtndew	Steve's home machine	Tustin, California
mtxinu	mt Xinu	Berkeley, CA
muddcs	Harvey Mudd College	Claremont, CA
munnari	Computer Science, University of Melb	Australia
munsell	Advanced Electronic Systems of EPPS	Massachusetts
murphy	Murphy & Durieu	NYC, New York
musky2	Muskingum College	New Concord, Ohio
mustang	Ibis Systems, Inc.	Westlake Village C
mwc	Mark Williams Company	Northbrook, IL
mybest	Steve Paddock	Houston, Texas
mycroft	Mycroft Labs	Bayonne, NJ
n8ino	Mainstream	Merrimack, NH
nampak	Nampak Ltd I.S. Dept	Johannesburg
nastar	Digital Transmission Systems (DTS)	Duluth, Georgia
natinst	National Instruments Corporation	Texas
natural	Natural Intelligence, Inc.	Cambridge, MA
nautilus	Ministerio de Relaciones Exteriores	ARGENTINA
nbc1	National Broadcasting Company, Inc.	New York, New York
nbires	NBI, Inc.	Boulder, Colorado
ncar	Scientific Computing Division/NCAR	Boulder, Colorado
ncc	Precise Systems Corporation	Edmonton Alberta
ncm	Northwest Computer Maintenance, Inc.	Bellevue, WA
ncoast	North Coast Public Access Un*x	Hinckley, Ohio
ncr-sd	NCR Corporation, Rancho Bernardo	San Diego, CA
ncratl	NCR Corporation, E&M Atlanta	Duluth, Georgia
ncrats	NCR Customer Services Div - Atlanta	Atlanta, Georgia
ncrcae	NCR Corp., E&M-Columbia	West Columbia, SC
ncrcam	NCR Corporation, E&M Cambridge	Cambridge, Ohio
ncrcan	NCR Canada Ltd, MIS Department	Canada
ncrsea	NCR Corp., Western Washington Distri	Bellevue, WA
ncrwat	E & M Waterloo, NCR Canada Ltd.	Canada
ncrwic	NCR Corporation, Wichita, Kansas	Wichita, Kansas
ncsuvx	North Carolina State University Comp	Raleigh, NC
ndmath	Notre Dame University, Math Dept.	Notre Dame, IN
ndsuvax	North Dakota State University, Depar	Fargo, ND
nebulus	Alchemy Mindworks	Canada
necis	NEC Information Systems	Boxborough, MA
necntc	NEC Electronics Inc.	Natick, MA
necsun	NEC America San Jose	San Jose, CA
neda	Tele-Voice	Bellevue, WA
neoucom	Northeastern Ohio Universities Colle	Rootstown, Ohio
nessus	Shockwave Engineering	Santa Barbara, CA
netcom	Netcom - Online Communication Servic	San Jose, CA
netcomsv	Netcom - Online Communication Servic	San Jose, CA
netcon	Santa Monica College, Telecommunicat	Santa Monica, CA
netdev	Communication Systems Research	Dallas, Texas
netex	NetExpress Communications, Inc.	Vienna, Virginia
neti1	NETI, Inc.	Michigan
neti2	NETI, Inc.	Michigan
netmbx	netmbx Berlin	Germany
netsys	Netsys,Inc.	Chicago, Illinois
netxcom	NetExpress Communications, Inc	Vienna, Virginia
news	NASA Ames Research Center	Moffett Field, CA
next	NeXT, Inc.	Fremont, CA
nicmad	Nicolet Instrument Corp.	Madison, Wisconsin
ninja	db Systems	Ft Worth, Texas
nirvo	Nirvonics, Inc.	Plainfield, NJ
njin	Rutgers - The State University of Ne	Piscataway, NJ
njsmu	NJ State Medical Underwriters, Inc.	Lawrenceville, NJ
nli	Natural Language, Inc.	Berkeley, CA
nmrdc1	Naval Medical Research & Development	Bethesda, MD
noao	National Optical Astronomy Observato	Tucson, Arizona
node	McClary Associates	Palo Alto, CA
noe	Noe Systems, San Francisco	San Francisco, CA
noether	Institute for Theoretical Physics,	SUNY at Stony Broo
nominil	Lonesome Dove Computing Services	Austin, Texas
norvac	Norvac Electronics, Inc., Beaverton,	Oregon
nosc	Naval Ocean Systems Center	San Diego, CA
nosun	Sun Microsystems, Portland Oregon	Oregon
novatel	NovAtel Communications Ltd.	Alberta
novavax	Nova University	Fort Lauderdale FL
now	Now Communications	Canada
noweh	Noweh Software	Ontario
npal	Pal Network Services	New Palestine, IN
npiatl	Network Publications, Incorporated	Lawrenceville, GA
nrcvax	Network Research Corp.	Oxnard, California
ns	Network Systems Corporation	Minnesota
nshore	Nshore Salvage and Hacking	Ohio
nsq	no organization	Mississauga Ontari
nstar	Gator Communications	South Bend, IN
ntg	New Technologies Group, Inc.	Palo Alto, CA
ntrlink	Interlink Computer Sciences, Inc.	Fremont, CA
ntvax	University of North Texas	Denton, Texas
nuchat	South Coast Computing Services, Inc.	Texas
nucleus	The Nucleus	Clarkston, MI
nuconvex	CONnecticut Valley Electric eXchange	Southington, CT
nucsrl	Northwestern University	Evanston, Illinois
null	U S WEST Communications	Omaha, Nebraska
nusdecs	National University	San Diego, CA
nusdhub	National University	San Diego, CA
nusjecs	National University, San Jose Campus	San Jose, CA
nuustak	CSIR Centre for Advanced Computing	South Africa ???
nwnexus	Northwest Nexus Inc.	Bothell, WA
nwsp	NorthWest Software Partners, Inc.	Portland, Oregon
nyit	NYIT Computer Graphics Laboratory	New York
nyser	New York State Education and Researc	New York
nyx	U. of Denver, Dept. of Math and Comp	Denver, Colorado
oakhill	Motorola	Austin, Texas
obdient	Obedient Software Corporation	Wheaton, Illinois
ocpt	CONCURRENT COMPUTER CORP, I.S. Dept.	mailstop
ocsqnt	Sequent Computer Systems - Field Sal	Costa Mesa, CA
oct1	Open Computer Technology (Pty) Ltd	South Africa
octela	Octel Communications Inc.	Milpitas, CA
octopus	Octopus Enterprises	Cupertino, CA
oddjob	University of Chicago	Chicago, Illinois
odgate	Odesta Corporation	Northbrook, IL
odyssee	Odyssee Recherches Appliquees inc.	Canada
oetl	Lockheed Missiles & Space Co.	Santa Cruz, CA
ogccse	Oregon Graduate Center, Dept. of Com	Beaverton, Oregon
ogicse	Oregon Graduate Institute, Dept. of	Beaverton, Oregon
ohio	Thomas Bros. Maps	Irvine, California
ohsu	The Oregon Health Sciences Universit	Oregon
ohsu-hcx	The Oregon Health Sciences Universit	Oregon
oink	Random Prime Research Institute	USA
okstate	Oklahoma State University, Dept. of	Stillwater, OK
ole	Cascade Design Automation Corporatio	Bellevue, WA
oli-stl	Olivetti Software Technology Laborat	Menlo Park, CA
oliveb	Olivetti Advanced Technology Center	Cupertino, CA
ollie	UCLA School of Engineering and Appli	Los Angeles, CA
olsa99	Olivetti Systems and Networks - Afri	South Africa
omen	Omen Technology Inc	Portland, Oregon
onfcanim	National Film Board of Canada/Office	Canada
ontenv	Ontario Ministry of the Environment	Canada
ontmoh	Ontario Ministry of Health	Canada
opac	Oregon State Library	Salem, Oregon
opel	Second Source, Inc.	Annapolis, MD
opsarg	Pan American Health Organization	Argentina
optigfx	Optigraphics Corporation	San Diego, CA
optilink	DSC Communications / Optilink	Petaluma, CA
optima	Optimage Interactive Services	USA
opusys	Opus Systems, Inc.	Cupertino, CA
ora	O'Reilly & Associates, Inc.	Cambridge, MA
oracle	Oracle Corporation	Belmont, CA
orage	Ripley Computing/Consulting Services	Hancock, Michigan
orc	Olivetti Advanced Systems	Cupertino, CA
oresoft	Oregon Software, Inc.	Portland, Oregon
orstcs	Computer Science Dept, Oregon State	Corvallis, Oregon
orstext	Oregon State University Extension Se	Corvallis, Oregon
orstnews	Oregon State University, Computing	Corvallis, Oregon
orville	Orville's Aircraft Factory	Westlake Village C
oryxmv6	Oryx Energy Company	Dallas, Texas
osc	Versant Object Technology	Menlo Park, CA
osiris	The Johns Hopkins Hospital	Baltimore, MD
otishq	American Automobile Association, Wor	Falls Church, VA
otto	Las Vegas Sun Newspaper	Nevada
oxtrap	Ocwen Trading, Inc.	Ann Arbor, MI
oxy	Occidental College Computer Center	Los Angeles, CA
pacbell	Pacific Bell	San Ramon, CA
pacer	Pacer Corporation	Bothell, WA
palan	Palantir Systems, Inc.	Pinellas Park, FL
palladium	Epoch Systems	Marlboro, MA
pallio	Gurus Anonymous	San Francisco, CA
pan	Adasoft AG, Bahnhofstrasse 728, 4622	Switzerland
panda	Verilink Corporation	San Jose, CA
pandora	Dallas Area NeXT Group (DaNG)	Texas
paninfo	Paninfo AG	Schwerzenbach
panix	PANIX Public Access Unix Systems of	Brooklyn, New York
paomail	Micro Focus Inc.	Palo Alto, CA
paperboy	Motorola Microcomputer Group	Tempe, Arizona
paradigm	Paradigm Associates Inc.	Cambridge, MA
parallax	Parallax Graphics Inc	Santa Clara, CA
parcplace	ParcPlace Systems, Inc.	Mountain View, CA
parkridge	Parkridge Computer Systems Inc.	Oakville
parsely	The Affiliates' Complex	Portland, Oregon
parvenu	Microport SysV 386 3.0e	St Paul, Minnesota
pbs	Public Broadcasting Service	Alexandria, VA
pbsi	Phone Base Systems, Inc.	Vienna, Virginia
pca54	Individual	El Segundo, CA
pdaeng	PDA Engineering	Costa Mesa, CA
pdi	Photon Dynamics	San Jose
pdn	AT&T Paradyne	Florida
pdxgate	Portland State Univ, Computer Scienc	Portland, Oregon
pecnos	Concurrent Computer Corporation, OS	Tinton Falls, NJ
pedsga	Concurrent Computer Corporation, SQA	Tinton Falls, NJ
pedsgd	Perkin-Elmer	Tinton Falls, NJ
pegasus	Pegasus Information Systems	Honolulu, Hawaii
pencom	Pencom Systems, Inc.	New York, New York
pensoft	Pencom Software Inc.	Austin, Texas
peora	Concurrent Computer Corporation	Orlando, Florida
percival	Percy's UNIX, Portland	Portland, Oregon
percy	Percy's UNIX, Portland	Portland, Oregon
peregrine	Peregrine Systems, Inc.	Carlsbad, CA
perle	Perle Systems Limited	Canada
perot	Perot Systems Corporation	Troy, Michigan
petf1	Concurrent Computer Corporation, Mar	Tinton Falls, NJ
petro	G.M. Andreen & Associates, Inc.	Texas
petsd	Concurrent Computer Corporation, Sof	Tinton Falls, NJ
pgt1	Princeton Gamma-Tech, Inc.	Princeton, NJ
philabs	Philips Laboratories, North American	New York
philmtl	Philips Electronics Limited	St Laurent, QC
phlpa	Ians Playhouse	Phila, PA
photon	Photon Research Associates, Inc.	San Diego, CA
phri	Public Health Research Institute	New York
phw5	Pipeline Associates, Inc.	Lake Hiawatha, NJ
piddle	Stephen Dampier	N C
pikes	University of Colorado at Denver	Colorado
pilatus	Institut fuer Integrierte Systeme,	Switzerland
pilchuck	Data I/O Corporation	Redmond, WA
pilot	The Pilot House	CA, California
pipeline	Pipeline Associates, Inc.	West Orange, NJ
pitt	University of Pittsburgh, Computer	Pittsburgh, PA
pixar	Pixar	Richmond, CA
pixel	Pixel Point Computers Inc.	Alberta
piziali	Pizialis	Texas
pjetech	Paul Jones Enterprises	Marlton, NJ
plains	North Dakota Higher Education Comput	Fargo, ND
plato	Aratar (Software Consulting)	San Francisco, CA
plseca	Control Data Corporation	Pleasanton, CA
plus5	PFCS Corporation	Manchester, MO
pmafire	Westinghouse Idaho Nuclear Co., Inc.	Idaho Falls, Idaho
pochoclo	Ministerio de Relaciones Exteriores	ARGENTINA
polari	Seattle Online	Seattle, WA
polarsun	Technetics Corporation / Information	New York
polarvax	Technetics Corporation / Information	New York
pollux	Department of Electical Engineering	Dallas, Texas
polstra	John D. Polstra & Co., Inc.	Seattle, WA
polygen	Polygen Corporation	Waltham, MA
polyof	Polytechnic University, Farmingdale	Farmingdale, NY
polyslo	California Polytechnic State Univers	San Luis Obispo CA
portal	Portal Communications Company	Cupertino, CA
poseur	Sun Microsystems, Inc.	USA
pporta	Romed Research	th Place Tulsa, OK
practic	Practical Computing Inc.	Sunnyvale, CA
prairie	Prairie Computing	Madison, Wisconsin
prapc2	Paul Raulerson & Associates	Norristown, PA
prcrs	Planning Research Corporation, Realt	McLean, Virginia
premise	Premise, Inc.	Cambridge, MA
presby	Presbyterian-Univ. of Pennsylvania	Philadelphia, PA
pri	P. Ruggieri, Inc.	USA
pride386	Pride Plastics	Beuna Park, CA
primerd	Prime Computer, Inc.	Framingham, MA
prlb2	Philips Research Laboratory Brussels	Belgium
problem	General Techniques Computer Systems	Ontario
procase	PROCASE Corporation	Santa Clara, CA
prometheus	Prometheus II, Ltd.	College Park, MD
proto	Prototronics	Sandpoint, Idaho
protocol	Protocol Systems, Inc.	Beaverton Oregon
provar	KW Networks	Ontario
prowest	Professional Press - West Coast Offi	Pasadena, CA
proxima	The People's Democratic Anarchy	South Africa
psivax	Pacesetter Systems Inc., A Siemens	Sylmar, California
psu-cs	Portland State University, Departmen	Portland, Oregon
psueea	Portland State University, Departmen	Portland, Oregon
psuhcx	The Pennsylvania State University En	University Park PA
psuvax1	Penn State University, Computer Scie	University Park PA
pte	Precise Technology & Electronics	Warren, Michigan
ptlwest	Phoenix Technologies, Ltd.	Scotts Valley, CA
puck	Moonlight Systems	Concord, MA
puff	University of Wisconsin, Computer Sc	Madison, Wisconsin
puivax	Philips Ultrasound International	California
pur-ee	Purdue University, Electrical Engine	W Lafayette, IN
pur-phy	Purdue University, Physics Dept.	W Lafayette, IN
purdue	Purdue University, Dept. of Computer	W Lafayette, IN
pwcs	City of St. Paul Public Works Comput	Saint Paul, MN
pyramid	Pyramid Technology Corporation	San Jose, CA
pyrchi	Pyramid Technology Corp. - Central	Des Plaines, IL
pyrdc	Pyramid Technology Corp., Washington	Vienna, Virginia
pyrnj	Pyramid Technology Corporation	Woodbridge, NJ
pyrtech	Pyramid Technology Corporation, Remo	Mountain View, CA
pyrtor	Pyramid Technology Canada	ONT
pzbaum	Perfecto Zissbaum	Portland, Oregon
qantel	MDS Qantel Corp.	Hayward, CA
qcc-hal	QCC Communications Corporation	Canada
qcdev	Tandy Electronics, National Parts Di	Fort Worth, Texas
qetzal	The WhiteStar Corporation	Englewood, CO
qiclab	SCN Research/QIC Laboratories of Tig	Tigard Oregon
qii	Quality Institute International, Inc	St Paul, Minnesota
qmet	Qualimetrics, Incorporated	Sacramento, CA
qnorth	Quadratron Canada Inc.	Quebec
qsp	Quality Software Products	Culver City, CA
qst1	Quality Software Tools	Costa Mesa, CA
qtc	Quantitative Technology Corporation	Oregon
quack	The Duck Pond (public access unix)	Santa Clara, CA
quad1	Quadratron Systems Inc.	California
quagga	Rhodes University Computing Centre	South Africa
questar	Questar Data Systems	Eagan, Minnesota
quintro	Quintron Corporation	Quincy, Illinois
quintus	Quintus Computer Systems	Mountain View, CA
r-node	R-Node Public Access UNIX System	Ontario
r2	R2 Computer Consultants	Ontario
racerx	Bridge Information Systems, Inc.	St Louis, Missouri
radar	Nashville Macintosh User's Group	US Mail
radix	Radix MicroSystems, Inc.	Beaverton, Oregon
raider	RaiderNet Public Access	Murfreesboro, TN
rainbow	Individual	San Francisco, CA
ralmar	Ralmar Business Systems	San Jose, CA
rama	Harris Scientific Calculations Inc.,	New York
ramoth	Encore Computer Corporation	New York
randvax	The RAND Corporation	Santa Monica, CA
raven	eklektix	Boulder, Colorado
ray	Raymond Schafer Associates	Lorena, Texas
raybed2	Raytheon Company, Missile Systems Di	Tewksbury, MA
rayssd	Raytheon Company	Portsmouth, RI
rb-dc1	Gould, Computer Systems Division	San Diego, CA
rbdc	Red Barn Data Center	Salem, NC
rcf	not much	Dublin, California
rcorsa	RCO Consultants	Canada
rdlvax	Research Development Laboratories	Culver City, CA
rducky	Technical Solutions	Arroyo Grande, CA
reason	Technetics Corporation	Riverdale, NY
rebel	Forte Technologies - Atlanta	Berkeley Lake, GA
redpoll	Bug & DNA Labs Annex (aka Home)	Munroe Falls, Ohio
redsox	The Boston Software Works, Inc.	Boston, MA
redsun	Research and Evaluation - Portland	Oregon
redvax	D. Hugh Redelmeier	CANADA
redwood	Rob Warnock, Systems Architect	San Mateo, CA
reed	Reed College	Portland, Oregon
reel	Sceptre Corporation	Ann Arbor, MI
regina	University of Regina, Computing Serv	Regina, SK
rehab1	Reading Rehabilitation Hospital	Reading, PA
rei2	Recognition Equipment Inc.	Dallas, Texas
rel	UUCP Mapping Project, Michigan Coord	Farmington, MI
relay	Hewlett-Packard Company	Palo Alto, CA
rencon	Tudor Consulting	Fremont, CA
reo	Colorado Wing, Civil Air Patrol	Colorado
research	AT&T Bell Labs	Murray Hill, NJ
retix	Retix, Santa Monica	Santa Monica, CA
rex	Tulane University, Dept. of Computer	New Orleans, LA
riacs	Research Institute for Advanced Comp	Moffett Field, CA
richsun	Rich Inc.	Oakbrook, Illinois
rit	Rochester Institute of Technology	Rochester, NY
ritcsh	Computer Science House @ Rochester	Rochester, NY
rlgvax	Computer Consoles, Inc., Office Syst	Reston, Virginia
rmkhome	The Man With Ten Cats	Framingham, MA
rna	Rockefeller University, Department	New York, New York
robechq	Robec, Inc.	Horsham, PA
robohack	Elegant Communications Inc. & UniFor	Canada
rochester	University of Rochester, Dept. of Co	Rochester, NY
rocksanne	Xerox/Webster	Webster N Y
romed	MicroAge Technical Marketing	Tempe, Arizona
ronin	Ronin House, Publishing	Peterborough, NH
rosevax	Rosemount Inc.	Eden Prairie, MN
royaljok	The Joker's Wild	Indianapolis, IN
royko	Chicago Software Works	Cary, Illinois
rphroy	Physics Department, General Motors	Michigan
rpmc	Resources Property Management Corp.	New York, New York
rpp386	D/B/A River Parishes Programming	Dallas, Texas
rsf	Radio Shack Franchise Division	Ft Worth, Texas
rt1	N4, Los Alamos National Laboratory	Los Alamos, NM
rtech	Relational Technology, Inc.	Alameda, CA
rti	Research Triangle Institute	Research Triangle
rwing	Highly Unlikely	Seattle, WA
rwj	The Robert Wood Johnson Foundation	Princeton, NJ
rwmke	River West	Wisconsin
rwsys	R/W Systems - Fine purveyors of cust	Richland Hills, TX
ryescs	School of Computer Science, Ryerson	Canada
ryesone	School of Computer Science, Ryerson	Canada
ryptyde	Ryptyde TimeSharing/SWATSCOLPAC	Coronado, CA
s3ridge	S-Cubed	San Diego, CA
s3sun	S-Cubed	San Diego, CA
s4mjs	Home machine	Plainfield, NJ
s5	Morgan Stanley & Co., Inc.	NY, New York
s5000	UNISYS - Open Software Products	St Paul, Minnesota
sactoh0	Sacramento Public Access UNIX	Sacramento, CA
safari	Safari Time Labs	Oregon
sagepub	Sage Publications, Inc.	Newbury Park, CA
sal	TurboCit Salamandria at Richardson,	Richardson, Texas
sam	DAVID Systems, Inc.	Sunnyvale, CA
samsung	Samsung Software America, Inc.	Andover, MA
sarge	Verdix Corporation, Corporate Headqu	Chantilly, VA
sat	SAT Corporation	Sunnyvale, CA
satco	Saturday Company	Waterbury, Vermont
savax	Lockheed Sanders, Inc.	Nashua, NH
saylor	Saylors Software First	Eden Prairie, MN
sbanet	Santa Barbara Area Network (SBANET)	Carpinteria, CA
sbcs	State University of New York at Ston	Stony Brook, NY
sbsvax	Universitaet des Saarlandes, FB Info	Germany
sbuf01	St. Barnabas Church	Depew, New York
sbuf02	St. Mary of the Assumption	Lancaster, NY
sbuf03	Nativity of Our Lord	Orchard Park, NY
sbuf04	St. Amelia Parish	Tonawanda, NY
sbuf05	Our Lady Help of Christians	Cheektowaga, NY
sc50	Unisys Canada Customer Support Cente	Canada
scampi	Systems Control	Palo Alto, CA
scbhq	South Central Bell	Birmingham, AL
sceard	Sceard Systems, Inc.	Vista, California
scenic	ScenicSoft, Inc.	Edmonds, WA
sci	Silicon Compiler Systems Corporation	San Jose, CA
sci34hub	SCI Systems, Inc.	Huntsville, AL
scicom	Alpha Communications Development Cor	Colo
sclcig	Southam Communications Limited (CNS)	Ontario
scubed	S-Cubed	San Diego, CA
sda	SDA Systems, San Jose	San Jose, CA
sdamos	Univ. of California, San Diego, Phon	La Jolla, CA
sdchem	Univ. of California, San Diego, Dept	La Jolla, CA
sdcrsi	Cray Research Superservers Inc., San	San Diego, CA
sdcsvax	University of California at San Dieg	La Jolla, CA
sdf	sdf Public Access UNIX, Dallas	Lewisville, Texas
sdgsun	SDG Division of SAIC Comsystems	Winter Park, FL
sdiego	Harris Computer Systems	San Diego, CA
sdp	Intel Corporation, OMSO Software Eng	Hillsboro, Oregon
sdrc	Structural Dynamics Research Corpora	Milford, Ohio
sdsioa	Univ. of Calif, San Diego, Scripps	La Jolla, CA
sdsu	San Diego State University	S D, California
sdti	Software Development Technologies,	Sudbury, MA
seac	SEAC Software Engineering, Inc.	Canada
seaside	Sunset Pacific Datacomm	Santa Monica, CA
secyt	Secretaria de Estado de Ciencia y Te	Argentina
seer	Brad Lanam Walnut Creek	California
sei	Carnegie-Mellon University - Softwar	Pittsburgh, PA
seila	SEI Information Technology, Los Ange	Los Angeles, CA
sendai	Digital Works Ltd.	Ann Arbor, MI
seq	Univ. of North Carolina at Wilmingto	North Carolina
serene	RF Engineering	Del Mar, CA
servio	Servio Corporation	Beaverton, Oregon
sgi	Silicon Graphics Computer Systems	Mountain View, CA
sgihbtn	Sierra Geophysics, Inc.	Kirkland, WA
shade	Ripley Computing/Consulting Services	Hancock, Michigan
shadow	Control Data Corporation	Atlanta, Georgia
shakti	National Centre for Software Technol	INDIA
shamash	Control Data Corporation, Computer	Arden Hills, MN
sharkey	Research Systems, ITD, The Universit	Ann Arbor, MI
shell	Shell Oil Co.	Houston, Texas
shower	Warm Fuzzies	Portland, Oregon
shuksan	Man Machine Systems Technology	Seattle, WA
shyoon	Digital Innovations, Inc.	Chelmsford, MA
sialis	Southern Minnesota Wing Confederate	Minneapolis, MN
sickkids	Hospital for Sick Children, Research	Canada
sid3b2	University of Miami - Dept. of Engin	Coral Gables, FL
sid3b2b	University of Miami - Dept. of Engin	Coral Gables, FL
siemens	Siemens Corporate Research and Techn	Princeton, NJ
sigma	Summation Inc.	Kirkland, WA
sigmast	Sigma Systems Technology, Inc.	Buffalo, New York
sii	Software Innovations, Inc.	NH USA
siia	Software Innovations, Inc.	NH USA
simpact	Simpact Associates	San Diego, CA
sinix	Siemens AG Muenchen, DI ST SP 4, DI	Germany
sinkhole	University of North Florida, Computi	Jacksonville, FL
sir-alan	Bloomington Public Access UNIX	Bloomington, IN
sis	Sheridan College	Canada
siswat	Photon Graphics, Inc.	Houston, Texas
sivs	State IV Software	Orange, California
sjsca4	Schlumberger Technologies, ATE Divis	San Jose, CA
sjsumcs	San Jose State University, Math & Co	San Jose, CA
sjuphil	Saint Joseph's University, Academic	Philadelphia, PA
sjuvax	Saint Joseph's University, Academic	Philadelphia, PA
ska	Dan Keller Technical Services	U S A
skeeve	Arnold Robbins' home computer	Atlanta, Georgia
skill	Computer Skills	Euless, Texas
skivs	Smith-Kettlewell Eye Research Instit	San Francisco, CA
skypod	Skypod Communications Inc.	Ontario
skywest	Sky Computers, Inc. (Western Region)	Irvine, California
slammer	Just me & my computers	Norcross, Georgia
sli	Software Leverage, Inc.	Arlington, MA
slu70	St. Louis University, Earth and Atmo	St Louis, Missouri
slug	Applied Physics Laboratory, Universi	Seattle, WA
slustl	St. Louis University, Earth and Atmo	St Louis, Missouri
smeagol	Jet Propulsion Laboratory, Flight Co	Pasadena, CA
smersh	Bio-Rad, Inc.	Somerville, MA
smke03	St. John Vianney Parish	WI _____
smop	AID Computers	FRANCE
smsdpg	SMS Data Products Group, Inc.	Reston, Virginia
smu	Southern Methodist University, Dept	Dallas, Texas
snark	Thyrsus Enterprises	South Warren Avenu
sneaky	Gordon L. Burditt	Benbrook, Texas
snidely	PMD Resources	Westlake Village C
snitor	Siemens Nixdorf Information Systems	Ontario
sobeco	Sobeco Group inc. (Montreal)	Canada
softest	SofTest, Inc.	Woodland Hills, CA
soil	Princeton University Civil Engineeri	Princeton, NJ
sol	Vista Technologies	Schaumburg, IL
soledad	Systems Engineering Associates	San Diego, CA
soma	Neurophysiology Laboratory, Neurolog	Texas
sonyd1	Sony Business and Professional Group	Montvale, NJ
sonyusa	Sony Microsystems Corp.	San Jose, CA
sorak	Korea Advanced Institute of Science	Republic of Korea
sorl01	St James Cathedral Parish	Orlando, Florida
soul	Ampex Video Systems Corporation, Col	Colorado
sp7040	Unisys	Salt Lake City, UT
spatial	Spatial Technology, Inc.	Boulder, Colorado
spca6	U.S. Court of Appeals for the Sixth	Cincinnati, Ohio
spdcc	S.P. Dyer Computer Consulting	Cambridge, MA
spdyne	Spectradyne, Inc.	Richardson, Texas
spencer	Spencer's Crib (home system)	Ann Arbor, MI
sphinx	University of Chicago Computation Ce	RM
sphl01	Holmesburg Baptist Church	Phila, PA
sphl02	St Cecilia RC Church	Phila, PA
sphl03	Queen of Peace Church	Ardsley, PA
sphl04	St. Albert The Great Church	Huntingdon Valley
spies	Spies in the Wire, PUBLIC ACCESS UNI	Cupertino, CA
spiff	Management Information Consulting,	Arlington, VA
spirit	Grandville Assembly of God	Grandville, MI
spked	US Army Corps of Engineers, Sacramen	Sacramento, CA
spl1	The Software Public Library, Inc.	Chicago, Illinois
splut	Confederate Microsystems	League City, Texas
spock	Choate Rosemary Hall	Connecticut
spool	Marquette University	Wisconsin
spsd	Data General Corporation	Irvine, California
spt	The Entity	Cambridge, MA
spudnut	MicroAge HQ Technical Services	Tempe, Arizona
spycal	UNISYS, Calgary, Alberta, Canada	Alberta
srcsip	Honeywell Inc. Systems & Research Ce	MPLS, Minnesota
srea01	N.D. of Bethlehem	Bethlehem, PA
srea02	St. John the Baptist	Allentown, PA
srea03	St. Catharine of Siena	Reading, PA
srea04	St. Jane Fances Dechantel	Easton, PA
srea05	Our Lady of Mt Carmel	Doylestown, PA
srea06	St. Joseph the Worker	Orefield, PA
srea07	St. Anthony of Padua	Easton, PA
srea08	St. Thomas More	Allentown, PA
srea09	Immaculate Conception	Allentown, PA
srea10	St. Columbkill Parish	Boyertown, PA
srhqla	SilentRadio HeadQuarters, Los Angele	Chatsworth, CA
sri-unix	SRI International	Menlo Park, CA
ssbell	Sterling Software, FSG/IMD	Bellevue, Nebraska
ssbn	W.L. Kennedy Jr. & Associates	Texas
ssc	Specialized Systems Consultants, Inc	Seattle, WA
ssc-vax	Software Support Center	Seattle, WA
ssfo01	Good Shepherd	Pacifica, CA
ssi	Supercomputer Systems, Inc.	Eau Claire, WI
ssi3b1	Scientific Systems	Woburn, MA
ssui01	St Mary Church	Vacaville, CA
stag	Mindtools ST Access Group	Plymouth, MN
starfire	Starfire Consulting Services	Minneapolis, MN
starnet	Starnet Connections	Los Altos, CA
starnine	StarNine Technologies, Inc.	Berkeley, CA
statsci	Statistical Sciences Inc.	Seattle, WA
stb	The Serial Tree Board	Santa Monica, CA
stcvax	Storage Technology Corp.	Louisville, CO
stdoil	Standard Oil Production Company	Dallas Texas
stech	Scholastech telecommunications	Waltham, MA
steggie	BLT Enterprises	Mountain View, CA
stellar	Stellar Computer	Newton, MA
step	Step Engineering	Sunnyvale, CA
stephsf	Stephen Software Systems, Inc.	Tacoma, Washington
stiatl	Sales Technologies	Atlanta, Georgia
stmvax	Satellite Technology Management, Inc	Torrance, CA
stonewr	StoneWare	no mailing address
stpl	Institute for Space and Terrestrial	CANADA
stratsft	Strategic Software	Redford, Michigan
stratus	Stratus Western Development Center	San Jose, CA
stre01	Our Lady of Good Counsel	Moorestown, NJ
sts	Semiconductor Test Solutions	Santa Clara, CA
style	Style Us	Canada
sugar	Neosoft	Missouri City, TX
sun	Sun Microsystems Inc.	Mountain View, CA
sunarch	Sun Microsystems	Saint Louis, MO
sunatl	Sun Microsystems, Inc.	Atlanta, Georgia
sunbim	Belgian Institute of Management	Belgium
sunbird	Sun Microsystems Inc.	Suite
sunburn	Sun Microsystems, Phoenix Sales Offi	Phoenix, Arizona
sundc	Sun Microsystems, Inc.	Vienna, Virginia
suneast	Sun Microsystems Inc. - East Coast	Billerica, MA
suned1	USNSWSES NAVSEA Navy	Port Hueneme, CA
sunkist	Sun Microsystems Inc.	Irvine, California
sunloop	Sun Microsystems, Inc.	Chicago, Illinois
sunne	Sun Microsystems, New England Sales	Lexington, MA
sunpeaks	Sun Microsystems, Inc.	Englewood, CO
sunrise	Sun Microsystems, NJ District Office	Saddle Brook, NJ
sunrock	Sun Microsystems, Inc.	Fairport, New York
suntalk	Sun Microsystems of Canada, Inc.	Ontario
suntan	Sun Microsystems, San Diego District	San Diego, CA
suntri	Sun Microsystems North Carolina Sale	Cary, NC
sunvalley	Sun Microsystems, Utah Sales & Suppo	Salt Lake City, UT
sunybcs	State University of New York at Buff	Amherst, New York
super	The Supercomputing Research Center	Bowie, MD
surfsoft	Surf Software	Santa Cruz, CA
sw1a7	Southwestern Bell Telephone Co.	St Louis, Missouri
swamps	Swamp Systems	Churchville, NY
swatsun	Swarthmore College Computer Science	Swarthmore, PA
swbatl	Southwestern Bell Telephone Co., Adv	St Louis, Missouri
swlabs	Software Labs, Ltd.	Easton, CT
swri14be	Southwest Research Institute, Depart	Texas
swrinde	Southwest Research Institute	Texas
swsrv1	Software Services - Consulting/Contr	Garland, Texas
sx1100	UNISYS - Product & Technology Operat	St Paul, Minnesota
sybase	Sybase, Inc.	Emeryville, CA
sylvan	Unisys Incorporated	Eagan, Minnesota
synchro	SynchroSystems	Cambridge, MA
synergy	Synergy Microsystems, Inc.	Encinitas, CA
synopsys	Synopsys Inc.	Mountain View, CA
syntllct	Syntellect Inc.	Phoenix, Arizona
sysadm	/sys/admin, Inc.	Los Gatos, CA
sysadmin	/sys/admin, inc.	San Jose, CA
sysger	Tandy Research & Development	Fort Worth, Texas
tahoe	University of Nevada Reno, Mathemati	Nevada
tahoma	Boeing Commercial Airplane Co., Seat	Seattle, WA
tai	Amalgamated Spleen	Chicago, Illinois
talaris	Talaris Systems Inc.	San Diego, CA
tandem	Tandem Computers, Inc.	Cupertino, CA
taniwha	Taniwha Systems Design	Berkeley, CA
tao	Gary Kline	Chippewa Falls, WI
tapa	Pata Consulting	Wheeling, Illinois
tarkus	Tarkus - Calumet City, IL.	Calumet City, IL
tarpit	Automation Intelligence, Inc.	Maitland, Florida
tate	Ashton-Tate	San Jose, CA
tau-ceti	ISC - Bunker Ramo	Liberty Lake, WA
tbomb	ICE Engineering, Inc.	Whitmore Lake, MI
tci	Technology Concepts Inc., A Bell Atl	Sudbury, MA
tcsc3b2	The Computer Solution Company, Inc.	Midlothian, VA
tct	T C Telemanagement, Inc.	Clearwater, FL
td2cad	Intel Corporation, MGTS	Santa Clara, CA
tdat	Teradata Corporation	El Segundo, CA
tdmecr	Tandem Computers	Northville, MI
tdmfed	Tandem Computers	Reston, Virginia
tdmnj	Tandem Computers, Inc.	Hasbrouck Heights
tdmuscs2	Tandem Computers (ICON)	Austin, Texas
teaser	France-Teaser S.A.R.L.	SEVRES France
techbook	Techbooks of Beaverton Oregon	Beaverton Oregon
technix	Technix, Inc.	St Paul, Minnesota
techsup	Tandy/Radio Shack Technical Support	Ft Worth, Texas
teda	Teradyne EDA, Inc.	Santa Clara, CA
teemc	TMC & Associates	Troy, Michigan
tegra	Tegra-Varityper, Inc.	Billerica, MA
tekbspa	Teknekron Software Systems	Palo Alto, CA
tektronix	Tektronix, Inc.	Beaverton, Oregon
telcom	Tele-Communications Advisors	New Jersey
telcomm	Telcomm Engineering	Westminster, CA
telebit	Telebit Corporation	Sunnyvale, CA
telesci	Telesciences CO Systems, Inc.	Moorestown, NJ
telesoft	TeleSoft	San Diego, CA
telesys	TeleSys Development Systems	Mesa, Arizona
telly	Sound Software Ltd.	Canada
temvax	Institute for Survey Research, TEMPL	Philadelphia, PA
terminator	Computing Center, The University of	Ann Arbor, MI
terrapn	Terrapin Associates	Ridgefield, CT
tessi	Test Systems Strategies, Inc.	Beaverton, Oregon
texbell	Southwestern Bell Corporation	Texas
textware	Textware Intl.	Cambridge, MA
tfd	Twenty First Designs	Midway Islands
tfpbbs	The Floating Point Bulletin Board Sy	France
tgate	TransGate, Inc.	Irvine, California
tgs	Template Graphics Software, Inc	San Diego, CA
thehulk	Doyle Munroe Consultants, Inc.	Hudson, MA
theseas	National Technical University of Ath	GREECE
think	Thinking Machines Corporation	Cambridge, MA
thirdi	Third Eye Software, Inc.	Menlo Park, CA
thnkpos	EPH Information Systems	San Antonio, Texas
ti-csl	Texas Instruments	Dallas, Texas
tiamat	Ahlstrom Filtration, Inc.	Chattanooga, TN
tinton	Concurrent Computer Corporation, Gen	Tinton Falls, NJ
titn	TITN Inc.	Hayward, CA
tlc	Total Logic Corportation	San Jose, CA
tls	Thought Link Systems	Canada
tlxprs	Telexpress Incorporated	Willingboro, NJ
tmpmbx	netmbx Berlin	W Germany
tmsoft	TM Software Associates Inc., Toronto	Canada
tokugowa	DJINNI Software Development	Rochester, NY
tolerant	Tolerant Systems Inc.	San Jose, CA
torag	Torag Communication Systems	Canada
torsqnt	Sequent Computer Systems (Canada) Lt	Canada
toto	Grantville Associates	San Diego, CA
tots	Logicon, Inc., Tactical & Training	San Diego, CA
towers	Twin Towers	Indianapolis, IN
trac2000	United Engineers & Constructors - Ca	Philadelphia, PA
tredysvr	Unisys Corporation, Tredyffrin	Paoli, PA
tricom	TRICOM of Milwaukee	Park Plaza
tridom	AT&T Tridom	USA
trigraph	Trigraph Inc.	Canada
trilby	General Motors Research Trilby	Troy, Michigan
trillium	University of Texas at Austin	Department of Bota
trinet	General Techniques Computer Systems	Ontario
trixie	Gould Inc., Computer Systems Divisio	Bedford, NH
tron	Westinghouse Electronic Systems Grou	Baltimore, MD
tronsbox	Xanadu Enterprises, Inc.	Kearny, New Jersey
tropix	G.C.A. Corporation, Tropel Division	Fairport, New York
trotter	United States Military Academy, West	West Point, NY
trsvax	Tandy Electronics	Ft Worth, Texas
trwind	TRW Information Networks Division	Torrance, CA
trwrb	TRW Electronics and Defense Sector	Redondo Beach, CA
trwrc	TRW Military Electronics and Avionic	San Diego, CA
trwspp	TRW, Inc.	Redondo Beach, CA
trystro	Trystero System	Somerville, MA
tscs	Total Support Computer Systems	Florida
tsdiag	CONCURRENT COMPUTER CORP, Technical	mailstop
tsltor	Teleride Sage Limited	Ontario
tslwat	Teleride Sage Limited	Waterloo, Ontario
ttidca	Citicorp/TTI	Santa Monica, CA
ttisms	Touch Technologies	San Diego, CA
tts	Think Tank Software	Downey, California
ttsi	Tandem Telecommunications Systems In	Plano, Texas
tub	TU Berlin, Institut f. Kommunikation	Germany
tulsix	$USR Association Mail & News Hub	Tulsa, Oklahoma
tumuc	TU Muenchen, Lehrstuhl fuer Rechnerg	W Germany
tundra	Sun Microsystems - Bloomington	Bloomington, MN
turtlevax	CIMLINC, Inc.	Menlo Park, CA
tusun2	University of Tulsa, Department of	Tulsa, Oklahoma
tvcent	TVC Enterpises	Canada
twinsun	Twin Sun, Inc.	El Segundo, CA
twwells	T. William Wells	Mt Laurel, NJ
txsil	Summer Institute of Linguistics	Dallas Texas
tygra	Detroit Direct Marketing, Inc.	Clinton TWP, MI
tymix	BT Tymnet, Inc.	San Jose, CA
u36	Unit 36 Research	Canada
uahcs1	University Of Alabama In Huntsville	Huntsville, AL
uakari	University of Wisconsin, Wisconsin	Madison, Wisconsin
ub	State University of New York at Buff	Buffalo, New York
ub4b	BUUG : Belgian Unix User Group	Belgium
ubbs-nh	RAM Technology	Nashua, NH
ucbvax	University of California at Berkeley	Berkeley, CA
uccba	University of Cincinnati, College of	Cincinnati, Ohio
ucdavis	University of California at Davis	Davis, California
ucf-cs	Univ. of Central Florida, Computer	Orlando, Florida
uchdcc	University of Chile, Dept. of Comput	CHILE
uci	Unified Communications Incorporated	Bloomington, MN
uci-ics	Univ. of Calif, Irvine. Info. and Co	Irvine, California
ucivax	Univ. of Calif, Irvine. Info. and Co	Irvine, California
ucla-an	Department of Anesthesia, School of	Los Angeles, CA
ucla-cs	University of California, Los Angele	Los Angeles, CA
ucla-se	UCLA School of Engineering and Appli	Los Angeles, CA
ucla-seas	UCLA School of Engineering and Appli	Los Angeles, CA
uclachem	UCLA Department of Chemistry and Bio	Los Angeles, CA
uclfynu	Universite Catholique de Louvain	Belgium
ucmsa	ALAMO Matchmaker	RESERVED
ucmsj	The Silicon Matchmaker	Santa Clara, CA
ucqais	University of Cincinnati, College of	Cincinnati, Ohio
ucrmath	University of California at Riversid	Riverside, CA
ucsbcsl	University of California at Santa Ba	Santa Barbara, CA
ucscc	Computer Center, University of Calif	Santa Cruz, CA
ucsd	University of California at San Dieg	La Jolla, CA
ucsdhub	University of California at San Dieg	La Jolla, CA
ucsfcgl	University of California, San Franci	San Francisco, CA
ucsfmis	University of California at San Fran	San Francisco, CA
udc	Motorola Computer Group, Urbana Desi	Urbana, Illinois
udcps3	University of Dayton Computer Scienc	Ohio
udel	University of Delaware	Newark, Delaware
udiego	Academic Computing, University of Sa	San Diego, CA
uecok	East Central Oklahoma State Universi	Oklahoma
uflorida	Univ. of Florida, Computer and Infor	Gainsville, FL
ufrmsa1	Uniforum SA	Pinegowrie
ugc	UGC Consulting Ltd.	Sherwood Park Albe
ugn	/usr/group/nebraska	Omaha, Nebraska
uhasun	University of Hartford, Computer Sci	West Hartford, CT
uhccux	University of Hawaii Computer Center	Honolulu, Hawaii
uhnix1	University of Houston, Academic Comp	Houston, Texas
ui3	Microelectronics Research Center	Moscow, Idaho
uiucdcs	University of Illinois at Urbana-Cha	Urbana, Illinois
uiucuxc	University of Illinois at Urbana-Cha	Urbana, Illinois
uka	Universitaet Karlsruhe, Informatik	Germany
ukc	UKnet Backbone, Computing Laboratory	NF
ukma	Univ. of Kentucky, Dept. of Computer	Lexington, KY
ulowell	University of Lowell	Lowell, MA
ultra	Ultra Network Technologies	San Jose, CA
umcc	University of Michigan Computing Clu	Ann Arbor, MI
umich	Information Technology Division, The	Ann Arbor, MI
umix	Computing Center, The University of	Ann Arbor, MI
umn-cs	University of Minnesota, Computer Sc	Minneapolis, MN
umt	University of Montana Computer Cente	Missoula, Montana
unc	University of North Carolina, Dept.	Chapel Hill, NC
unccvax	University of North Carolina at Char	Charlotte, NC
undeed	Department of Electronic Engineering	South Africa
unet	Network Equipment Technologies, Inc.	Redwood City, CA
unf7	University of North Florida, Computi	Jacksonville, FL
unh	University of New Hampshire	Durham, NH
unhd	University Computing	Durham, NH
unhtel	University of New Hampshire Telecomm	Durham, NH
uni4um	Uniforum Association	Santa Clara, CA
unibase	Unibase Telecom Ltd.	Regina, SK
unicom	Science Computer Center, Marin Commu	Kentfield, CA
unicon	UNICON System Integration	Santa Ana, CA
unido	Universitaet Dortmund, Informatik /	Germany
unidot	Unidot	Golden, Colorado
unify	Unify Corporation	Sacramento, CA
unimtl	UniForum Montreal	Montreal, QC
uniol	Universitaet Oldenburg, FB Informati	Germany
unisoft	UniSoft Corporation	USA
united	United System Solutions Inc.	Toronto, Ontario
unixprt	Unixprt	Milpitas, CA
unizh	University of Zuerich, Institut fuer	Switzerland
unmvax	University of New Mexico, Department	Albuquerque, NM
unocss	University of Nebraska at Omaha, Mat	Nebraska
unr	University of Nevada, Reno	Reno, Nevada
unrvax	University of Nevada - Reno	Reno, Nevada
unsvax	University of Nevada System Computin	Las Vegas, Nevada
unx-pc	Kentucky Unix Users	Louisville, KY
uokmax	University of Oklahoma, Engineering	Norman, Oklahoma
uop	University of the Pacific, Departmen	Stockton, CA
uoregon	University of Oregon, Computer Scien	Eugene, Oregon
uotcsi2	University of Ottawa, Computer Scien	CANADA
upaya	Greyston Community Network	Yonkers, New York
upba	United Phone Book Advertisers	Lincoln, Nebraska
uplherc	Utah Power & Light Company	Salt Lake City, UT
uport	Microport Systems	Scotts Valley, CA
upose	Interpose	Ann Arbor, MI
ur-cc	University of Rochester, University	Rochester, NY
ur-valhalla	University of Rochester Department	Rochester, NY
urartu	S.D.P.A. Center for Regional Studies	Cambridge, MA
usenix	USENIX Association	Berkeley, CA
usfvax2	University of South Florida, College	Florida
usl	University of Southwestern Louisiana	Lafayette, LA
usource	UniSource, Inc.	US Mail
uswat	U S WEST Inc	Boulder, Colorado
ut-emx	The University of Texas at Austin,	Austin, Texas
utacfd	Univ. of Tx at Arlington	Arlingtion, Texas
utah-cs	University of Utah, Computer Science	Salt Lake City, UT
utah-gr	University of Utah, Computer Science	Salt Lake City, UT
utah-muddy	University of Utah, Computer Science	Salt Lake City, UT
utah-sp	University of Utah, Computer Science	Salt Lake City, UT
utah-ug	University of Utah, Computer Science	Salt Lake City, UT
utanes	Univ. of Texas Health Science Ctr.	San Antonio, Texas
utastro	University of Texas, Astronomy/McDon	Austin, Texas
utdoe	Dictionary of Old English Project -	CANADA
utgard	Quality Medical Adjudication (QMA),	Rancho Cordova, CA
util20	Utilities Engineering, GE Erie	Erie, Pennsylvania
utoday	UNIX Today	Manhasset, NY
utzoo	University of Toronto, Zoology Dept.	Canada
uudell	Dell Computer Corporation	Austin, Texas
uumind	Fortress Development HQ	Atlanta, Georgia
uunet	UUNET Technologies, Inc	Falls Church, VA
uupsi3	Performance Systems International,	New York
uupsi4	Performance Systems International,	New York
uupsi8	Performance Systems International,	New York
uuwest	The Dark Side of the Moon	Mountain View, CA
uvicctr	University of Victoria	Canada
uvm-gen	University of Vermont, Division of	Burlington, VT
uw-apl	Applied Physics Laboratory, Universi	Seattle, WA
uw-beaver	University of Washington, Dept. of	Seattle, WA
uw-coco	Univ. of Washington, MSCC Seattle,	Seattle, WA
uw-entropy	Univ. of Washington, Math/Stat, Seat	Seattle, WA
uw-nsr	National Simulation Resource in Mass	Seattle, WA
uw-warp	The Warp	Private
uwbln	UniWare Computer GmbH	Germany
uwmcsd1	University of Wisconsin - Milwaukee,	Milwaukee, WI
uworld	UNIXWorld Magazine	Mountain View, CA
uwvax	University of Wisconsin, Computer Sc	Madison, Wisconsin
vader	Boeing Helicopter Company / Boeing	Phila, PA
val	Video Associates Labs, Inc.	Austin, Texas
valid	Valid Logic Systems, Inc.	San Jose, CA
vamsf	Unisys Value Added Marketing	San Jose, CA
van-bc	Wimsey Information Technologies	Port Moody, BC
varian	Varian Chromotagraphy Systems Busine	California
vdbsan	BellSouth Advanced Networks, Inc.	Suite
vdelta	Volt Delta Resources	Orange, California
vdx	Verify Data Corporation	California
vector	Dallas Semiconductor Inc.	Dallas, Texas
vedge	Visual Edge Software Ltd.	Canada
vela	Oakland University, Academic Compute	Rochester, MI
verde	Courier Terminal Systems	Phoenix, Arizona
verdix	Verdix Corp., Western Operations	Aloha, Oregon
veritas	VERITAS Software	Santa Clara, CA
versatc	Versatec, Inc. (A XEROX Company)	Santa Clara, CA
vicstoy	vicstoy Public Access Unix	Orlando, Florida
vijit	Vijit Consulting	Oak Lawn, Illinois
vine	Vine Technology	Cupertino, CA
viper	Long Island Amateur Radio TCP/IP Net	New York
virgil	EDO Corporation, Command Systems Div	Chesapeake, VA
virgin	Virgin Software, Ltd.	Epping, NH
virginia	University of Virginia Academic Comp	Charlottesville VA
vis	Virtual Infinity Systems	San Diego, CA
vitanoc	Vitalink Communications Corporation	Fremont, CA
viusys	Unisys D.A. MINIS Project Management	McLean, Virginia
vixie	Vixie Home Computing	Palo Alto, CA
vk2bea	Broadcast Sports Technology Inc.	Crofton, MD
voder	National Semiconductor, Linear Desig	Santa Clara, CA
voodoo	Boeing Computer Services	Seattle, WA
vortex	Vortex Technology	Topanga, CA
vpnet	GPS Microdata	Villa Park, IL
vrdxhq	Verdix Corporation, Corporate Headqu	Chantilly, VA
vsedev	VSE Corporation	Arlington, VA
vsi	V-Systems, Inc.	Santa Ana, CA
vsi1	Vicom Systems, Inc.	Fremont, CA
vta	Video Tape Associates	Atlanta, Georgia
vtserf	Virginia Polytechnic Inst. & State	Blacksburg, VA
vu-vlsi	Villanova University, Dept. of Elect	Villanova, PA
vub	Vrije Universiteit Brussel, Medische	Belgium
wa4mei	Randy Jarrett Ham Packet Radio Gatew	Chamblee, Georgia
wang	Wang Laboratories Inc.	Lowell, MA
wang7	WANG Laboratories, Inc.	Lowell, MA
wariat	Akademia Pana Kleksa - Public Access	Ohio
wasatch	University of Utah, College of Engin	Salt Lake City, UT
watcgl	Computer Graphics Laboratory, Univer	Canada
watmath	Math Faculty Computing Facility, Uni	Canada
watson	Baylor College of Medicine	Texas
wattres	Steven Watt, Consultant	San Jose, CA
waynar	CalComp Inc., A Lockheed Company	Hudson, NH
wb9rxw	American Airlines - STIN	Grand Prairie, TX
wd0gol	Robert Barker & Associates	Eden Prairie, MN
wdl1	Loral Western Development Labs	San Jose, CA
web	Nirv Non-Profit Community Resource	Canada
websta	Daniel Webster College	Nashua, NH
weitek	WEITEK Corporation	Sunnyvale, CA
well	Whole Earth 'Lectronic Link	Sausalito, CA
wells	Wells Computer Systems Corporation	Penna
westmark	Westmark, Inc.	Warren, New Jersey
westsci	Solbourne Computers, Santa Clara	Santa Clara, CA
wet	Wetware Diversions	San Francisco, CA
wetware	Wetware Services	Fremont, CA
wgc386	New England Software Laboratories	Nashua, NH
whale	Associates Group	Stone Harbor, NJ
wheaton	Wheaton College	U S A
whitney	IMA, Inc	Anaheim, CA
whizz	Overture Systems Corporation	Lake Oswego, OR
whome	home of the Wrede family	Canada
whooper	Committee for Common Man	Austin, Texas
wicat	WICAT Systems, Inc.	Orem, Utah
widener	Widener University Computer Science	Chester, PA
wierius	Niche Computer Consulting	Tempe, Arizona
wiley	TRW Inc.	Redondo Beach, CA
will	Ogburn Stouffer Center, University	Chicago, Illinois
winfree	Garbee and Garbee, Computer / Graphi	Black Forest, CO
winnie	Godfrey Winham Laboratory, Princeton	Princeton, NJ
winston	Winston Tire Company, Burbank	Burbank, CA
wisdom	Wisdom's Pony Express	Lake Hiawatha, NJ
wiskit	Kitchen Wisdom Publishing Company	Oregon
wixer	Real/Time Communications	Austin, Texas
wizvax	Gilgut Enterprises, Inc.	Mass
wjh12	Harvard University, Psychology and	Cambridge, MA
wjvax	Watkins-Johnson	San Jose, CA
wlbr	Contel Federal Systems Division	Westlake Village C
wolv	University of Michigan Computing Clu	Ann Arbor, MI
wolves	Wolves Den UNIX, Durham NC	Durham, NC
woodowl	woodowl	Livermore, CA
world	Software Tool & Die	Brookline, MA
wotan	Compaq Computer Corporation	Texas
wraith	Raymond Browder	Ypsilanti, MI
wrangler	W.L. Kennedy Jr. & Associates	Texas
wright	Wright State University, Department	Kettering, Ohio
wrs	Wind River Systems, Inc.	Alameda, CA
wsccs	Weber State College Computer Science	Ogden, Utah
wsu-cs	Wayne State University, Computer Sci	Room
wuarchive	Washington University, Office of the	St Louis, Missouri
wucs1	Washington University, Dept. of Comp	St Louis, Missouri
wuphys	Washington University, Department of	St Louis, Missouri
wupost	Washington University, Office of the	St Louis, Missouri
wuthel	Wuthel's Living Room	Berkeley, CA
wvus	World Vision U.S.	Monrovia, CA
wyn386	Wynalda Litho Inc.	Rockford, Michigan
wyse	Wyse Technology	San Jose, CA
wyvern	Tidewater UNIX Users Group	Norfolk, Virginia
wzlr	Amalgamated Widgets, San Francisco	San Francisco, CA
xait	Xerox Corporation	Cambridge, MA
xanadu	Xanadu Operating Company	Palo Alto, CA
xanth	Old Dominion University, Department	Virginia
xavax	Crystal Data Systems, Inc.	Huntsville, AL
xdos	Hunter Systems Inc.	Mountain View, CA
xenon	Xenon systems, mail 'n' news	California
xilinx	Xilinx, Inc.	San Jose, CA
xios	XIOS Systems Corporation	Canada
xroads	Crossroads Development Company	Phoenix, Arizona
xrtll	WCOM, Toronto, Ont.	CANADA
xstor	Storage Dimensions, Inc.	San Jose, CA
xyzoom	Altruistic Intentions	Hollywood, CA
xyzzy	Data General Corp.	Research Triangle
yale	Yale University, Dept of Computer Sc	New Haven, CT
yang	University of Washington Center for	Seattle, WA
yarc	Yarc Systems, Inc.	Newbury Park, CA
yclept	:-) Leptons, Quarks & Bosons	Batavia, Illinois
yoyodyne	YoyoDyne Propulsion Systems Computer	Oregon
yunccn	York University Faculty of Environme	Canada
yunexus	York University Department of Comput	CANADA
z-code	Z-Code Software Corp.	San Rafael, CA
zap	Sylvie Parent, Architecte Paysagiste	Canada
zardoz	Custom Product Design, Inc.	Santa Ana, CA
zebra	very little	Colo
zehntel	Teradyne, Inc.	California
zeno	Smartware	Minneapolis, MN
zeus	SGS Management Informations Services	Canada
ziebmef	Ziebmef Public Access Unix	Ontario
zinn	Zinn Computer Company	Manchester, NH
zorch	SF-Bay Public Access Unix	Cupertino, CA
ztivax	Siemens AG, ZFE IO 2	Germany
zycad	Zycad Corporation	Menlo Park, CA
zygot	Announcement Technologies, Inc.	San Jose, CA
